CTCTTACGTAAGTAATAAGC -> TCTTACGTAAGTAATAAGCA
TCTTACGTAAGTAATAAGCA -> CTTACGTAAGTAATAAGCAC
CTTACGTAAGTAATAAGCAC -> TTACGTAAGTAATAAGCACC
TTACGTAAGTAATAAGCACC -> TACGTAAGTAATAAGCACCT
TACGTAAGTAATAAGCACCT -> ACGTAAGTAATAAGCACCTG
ACGTAAGTAATAAGCACCTG -> CGTAAGTAATAAGCACCTGG
CGTAAGTAATAAGCACCTGG -> GTAAGTAATAAGCACCTGGA
GTAAGTAATAAGCACCTGGA -> TAAGTAATAAGCACCTGGAG
TAAGTAATAAGCACCTGGAG -> AAGTAATAAGCACCTGGAGG
AAGTAATAAGCACCTGGAGG -> AGTAATAAGCACCTGGAGGC
AGTAATAAGCACCTGGAGGC -> GTAATAAGCACCTGGAGGCT
GTAATAAGCACCTGGAGGCT -> TAATAAGCACCTGGAGGCTC
TAATAAGCACCTGGAGGCTC -> AATAAGCACCTGGAGGCTCG
AATAAGCACCTGGAGGCTCG -> ATAAGCACCTGGAGGCTCGG
ATAAGCACCTGGAGGCTCGG -> TAAGCACCTGGAGGCTCGGG
TAAGCACCTGGAGGCTCGGG -> AAGCACCTGGAGGCTCGGGA
AAGCACCTGGAGGCTCGGGA -> AGCACCTGGAGGCTCGGGAA
AGCACCTGGAGGCTCGGGAA -> GCACCTGGAGGCTCGGGAAC
GCACCTGGAGGCTCGGGAAC -> CACCTGGAGGCTCGGGAACA
CACCTGGAGGCTCGGGAACA -> ACCTGGAGGCTCGGGAACAA
ACCTGGAGGCTCGGGAACAA -> CCTGGAGGCTCGGGAACAAG
CCTGGAGGCTCGGGAACAAG -> CTGGAGGCTCGGGAACAAGG
CTGGAGGCTCGGGAACAAGG -> TGGAGGCTCGGGAACAAGGA
TGGAGGCTCGGGAACAAGGA -> GGAGGCTCGGGAACAAGGAA
GGAGGCTCGGGAACAAGGAA -> GAGGCTCGGGAACAAGGAAT
GAGGCTCGGGAACAAGGAAT -> AGGCTCGGGAACAAGGAATG
AGGCTCGGGAACAAGGAATG -> GGCTCGGGAACAAGGAATGC
GGCTCGGGAACAAGGAATGC -> GCTCGGGAACAAGGAATGCT
GCTCGGGAACAAGGAATGCT -> CTCGGGAACAAGGAATGCTT
CTCGGGAACAAGGAATGCTT -> TCGGGAACAAGGAATGCTTT
TCGGGAACAAGGAATGCTTT -> CGGGAACAAGGAATGCTTTG
CGGGAACAAGGAATGCTTTG -> GGGAACAAGGAATGCTTTGC
GGGAACAAGGAATGCTTTGC -> GGAACAAGGAATGCTTTGCA
GGAACAAGGAATGCTTTGCA -> GAACAAGGAATGCTTTGCAG
GAACAAGGAATGCTTTGCAG -> AACAAGGAATGCTTTGCAGG
AACAAGGAATGCTTTGCAGG -> ACAAGGAATGCTTTGCAGGC
ACAAGGAATGCTTTGCAGGC -> CAAGGAATGCTTTGCAGGCC
CAAGGAATGCTTTGCAGGCC -> AAGGAATGCTTTGCAGGCCG
AAGGAATGCTTTGCAGGCCG -> AGGAATGCTTTGCAGGCCGG
AGGAATGCTTTGCAGGCCGG -> GGAATGCTTTGCAGGCCGGC
GGAATGCTTTGCAGGCCGGC -> GAATGCTTTGCAGGCCGGCC
GAATGCTTTGCAGGCCGGCC -> AATGCTTTGCAGGCCGGCCT
AATGCTTTGCAGGCCGGCCT -> ATGCTTTGCAGGCCGGCCTC
ATGCTTTGCAGGCCGGCCTC -> TGCTTTGCAGGCCGGCCTCC
TGCTTTGCAGGCCGGCCTCC -> GCTTTGCAGGCCGGCCTCCG
GCTTTGCAGGCCGGCCTCCG -> CTTTGCAGGCCGGCCTCCGT
CTTTGCAGGCCGGCCTCCGT -> TTTGCAGGCCGGCCTCCGTA
TTTGCAGGCCGGCCTCCGTA -> TTGCAGGCCGGCCTCCGTAG
TTGCAGGCCGGCCTCCGTAG -> TGCAGGCCGGCCTCCGTAGT
TGCAGGCCGGCCTCCGTAGT -> GCAGGCCGGCCTCCGTAGTG
GCAGGCCGGCCTCCGTAGTG -> CAGGCCGGCCTCCGTAGTGG
CAGGCCGGCCTCCGTAGTGG -> AGGCCGGCCTCCGTAGTGGA
AGGCCGGCCTCCGTAGTGGA -> GGCCGGCCTCCGTAGTGGAT
GGCCGGCCTCCGTAGTGGAT -> GCCGGCCTCCGTAGTGGATA
GCCGGCCTCCGTAGTGGATA -> CCGGCCTCCGTAGTGGATAC
CCGGCCTCCGTAGTGGATAC -> CGGCCTCCGTAGTGGATACG
CGGCCTCCGTAGTGGATACG -> GGCCTCCGTAGTGGATACGG
GGCCTCCGTAGTGGATACGG -> GCCTCCGTAGTGGATACGGA
GCCTCCGTAGTGGATACGGA -> CCTCCGTAGTGGATACGGAG
CCTCCGTAGTGGATACGGAG -> CTCCGTAGTGGATACGGAGG
CTCCGTAGTGGATACGGAGG -> TCCGTAGTGGATACGGAGGT
TCCGTAGTGGATACGGAGGT -> CCGTAGTGGATACGGAGGTG
CCGTAGTGGATACGGAGGTG -> CGTAGTGGATACGGAGGTGC
CGTAGTGGATACGGAGGTGC -> GTAGTGGATACGGAGGTGCA
GTAGTGGATACGGAGGTGCA -> TAGTGGATACGGAGGTGCAG
TAGTGGATACGGAGGTGCAG -> AGTGGATACGGAGGTGCAGC
AGTGGATACGGAGGTGCAGC -> GTGGATACGGAGGTGCAGCA
GTGGATACGGAGGTGCAGCA -> TGGATACGGAGGTGCAGCAG
TGGATACGGAGGTGCAGCAG -> GGATACGGAGGTGCAGCAGA
GGATACGGAGGTGCAGCAGA -> GATACGGAGGTGCAGCAGAC
GATACGGAGGTGCAGCAGAC -> ATACGGAGGTGCAGCAGACC
ATACGGAGGTGCAGCAGACC -> TACGGAGGTGCAGCAGACCC
TACGGAGGTGCAGCAGACCC -> ACGGAGGTGCAGCAGACCCC
ACGGAGGTGCAGCAGACCCC -> CGGAGGTGCAGCAGACCCCA
CGGAGGTGCAGCAGACCCCA -> GGAGGTGCAGCAGACCCCAC
GGAGGTGCAGCAGACCCCAC -> GAGGTGCAGCAGACCCCACA
GAGGTGCAGCAGACCCCACA -> AGGTGCAGCAGACCCCACAA
AGGTGCAGCAGACCCCACAA -> GGTGCAGCAGACCCCACAAA
GGTGCAGCAGACCCCACAAA -> GTGCAGCAGACCCCACAAAG
GTGCAGCAGACCCCACAAAG -> TGCAGCAGACCCCACAAAGT
TGCAGCAGACCCCACAAAGT -> GCAGCAGACCCCACAAAGTT
GCAGCAGACCCCACAAAGTT -> CAGCAGACCCCACAAAGTTT
CAGCAGACCCCACAAAGTTT -> AGCAGACCCCACAAAGTTTC
AGCAGACCCCACAAAGTTTC -> GCAGACCCCACAAAGTTTCC
GCAGACCCCACAAAGTTTCC -> CAGACCCCACAAAGTTTCCC
CAGACCCCACAAAGTTTCCC -> AGACCCCACAAAGTTTCCCA
AGACCCCACAAAGTTTCCCA -> GACCCCACAAAGTTTCCCAT
GACCCCACAAAGTTTCCCAT -> ACCCCACAAAGTTTCCCATG
ACCCCACAAAGTTTCCCATG -> CCCCACAAAGTTTCCCATGC
CCCCACAAAGTTTCCCATGC -> CCCACAAAGTTTCCCATGCC
CCCACAAAGTTTCCCATGCC -> CCACAAAGTTTCCCATGCCG
CCACAAAGTTTCCCATGCCG -> CACAAAGTTTCCCATGCCGA
CACAAAGTTTCCCATGCCGA -> ACAAAGTTTCCCATGCCGAT
ACAAAGTTTCCCATGCCGAT -> CAAAGTTTCCCATGCCGATA
CAAAGTTTCCCATGCCGATA -> AAAGTTTCCCATGCCGATAT
AAAGTTTCCCATGCCGATAT -> AAGTTTCCCATGCCGATATT
AAGTTTCCCATGCCGATATT -> AGTTTCCCATGCCGATATTG
AGTTTCCCATGCCGATATTG -> GTTTCCCATGCCGATATTGA
GTTTCCCATGCCGATATTGA -> TTTCCCATGCCGATATTGAA
TTTCCCATGCCGATATTGAA -> TTCCCATGCCGATATTGAAC
TTCCCATGCCGATATTGAAC -> TCCCATGCCGATATTGAACA
TCCCATGCCGATATTGAACA -> CCCATGCCGATATTGAACAG
CCCATGCCGATATTGAACAG -> CCATGCCGATATTGAACAGG
CCATGCCGATATTGAACAGG -> CATGCCGATATTGAACAGGT
CATGCCGATATTGAACAGGT -> ATGCCGATATTGAACAGGTT
ATGCCGATATTGAACAGGTT -> TGCCGATATTGAACAGGTTT
TGCCGATATTGAACAGGTTT -> GCCGATATTGAACAGGTTTA
GCCGATATTGAACAGGTTTA -> CCGATATTGAACAGGTTTAC
CCGATATTGAACAGGTTTAC -> CGATATTGAACAGGTTTACT
CGATATTGAACAGGTTTACT -> GATATTGAACAGGTTTACTA
GATATTGAACAGGTTTACTA -> ATATTGAACAGGTTTACTAT
ATATTGAACAGGTTTACTAT -> TATTGAACAGGTTTACTATA
TATTGAACAGGTTTACTATA -> ATTGAACAGGTTTACTATAG
ATTGAACAGGTTTACTATAG -> TTGAACAGGTTTACTATAGA
TTGAACAGGTTTACTATAGA -> TGAACAGGTTTACTATAGAA
TGAACAGGTTTACTATAGAA -> GAACAGGTTTACTATAGAAC
GAACAGGTTTACTATAGAAC -> AACAGGTTTACTATAGAACA
AACAGGTTTACTATAGAACA -> ACAGGTTTACTATAGAACAT
ACAGGTTTACTATAGAACAT -> CAGGTTTACTATAGAACATT
CAGGTTTACTATAGAACATT -> AGGTTTACTATAGAACATTG
AGGTTTACTATAGAACATTG -> GGTTTACTATAGAACATTGC
GGTTTACTATAGAACATTGC -> GTTTACTATAGAACATTGCC
GTTTACTATAGAACATTGCC -> TTTACTATAGAACATTGCCT
TTTACTATAGAACATTGCCT -> TTACTATAGAACATTGCCTG
TTACTATAGAACATTGCCTG -> TACTATAGAACATTGCCTGG
TACTATAGAACATTGCCTGG -> ACTATAGAACATTGCCTGGT
ACTATAGAACATTGCCTGGT -> CTATAGAACATTGCCTGGTC
CTATAGAACATTGCCTGGTC -> TATAGAACATTGCCTGGTCA
TATAGAACATTGCCTGGTCA -> ATAGAACATTGCCTGGTCAA
ATAGAACATTGCCTGGTCAA -> TAGAACATTGCCTGGTCAAG
TAGAACATTGCCTGGTCAAG -> AGAACATTGCCTGGTCAAGC
AGAACATTGCCTGGTCAAGC -> GAACATTGCCTGGTCAAGCA
GAACATTGCCTGGTCAAGCA -> AACATTGCCTGGTCAAGCAG
AACATTGCCTGGTCAAGCAG -> ACATTGCCTGGTCAAGCAGA
ACATTGCCTGGTCAAGCAGA -> CATTGCCTGGTCAAGCAGAA
CATTGCCTGGTCAAGCAGAA -> ATTGCCTGGTCAAGCAGAAG
ATTGCCTGGTCAAGCAGAAG -> TTGCCTGGTCAAGCAGAAGG
TTGCCTGGTCAAGCAGAAGG -> TGCCTGGTCAAGCAGAAGGC
TGCCTGGTCAAGCAGAAGGC -> GCCTGGTCAAGCAGAAGGCA
GCCTGGTCAAGCAGAAGGCA -> CCTGGTCAAGCAGAAGGCAA
CCTGGTCAAGCAGAAGGCAA -> CTGGTCAAGCAGAAGGCAAG
CTGGTCAAGCAGAAGGCAAG -> TGGTCAAGCAGAAGGCAAGT
TGGTCAAGCAGAAGGCAAGT -> GGTCAAGCAGAAGGCAAGTG
GGTCAAGCAGAAGGCAAGTG -> GTCAAGCAGAAGGCAAGTGG
GTCAAGCAGAAGGCAAGTGG -> TCAAGCAGAAGGCAAGTGGT
TCAAGCAGAAGGCAAGTGGT -> CAAGCAGAAGGCAAGTGGTA
CAAGCAGAAGGCAAGTGGTA -> AAGCAGAAGGCAAGTGGTAC
AAGCAGAAGGCAAGTGGTAC -> AGCAGAAGGCAAGTGGTACA
AGCAGAAGGCAAGTGGTACA -> GCAGAAGGCAAGTGGTACAG
GCAGAAGGCAAGTGGTACAG -> CAGAAGGCAAGTGGTACAGC
CAGAAGGCAAGTGGTACAGC -> AGAAGGCAAGTGGTACAGCA
AGAAGGCAAGTGGTACAGCA -> GAAGGCAAGTGGTACAGCAA
GAAGGCAAGTGGTACAGCAA -> AAGGCAAGTGGTACAGCAAA
AAGGCAAGTGGTACAGCAAA -> AGGCAAGTGGTACAGCAAAG
AGGCAAGTGGTACAGCAAAG -> GGCAAGTGGTACAGCAAAGA
GGCAAGTGGTACAGCAAAGA -> GCAAGTGGTACAGCAAAGAA
GCAAGTGGTACAGCAAAGAA -> CAAGTGGTACAGCAAAGAAT
CAAGTGGTACAGCAAAGAAT -> AAGTGGTACAGCAAAGAATG
AAGTGGTACAGCAAAGAATG -> AGTGGTACAGCAAAGAATGT
AGTGGTACAGCAAAGAATGT -> GTGGTACAGCAAAGAATGTA
GTGGTACAGCAAAGAATGTA -> TGGTACAGCAAAGAATGTAT
TGGTACAGCAAAGAATGTAT -> GGTACAGCAAAGAATGTATC
GGTACAGCAAAGAATGTATC -> GTACAGCAAAGAATGTATCA
GTACAGCAAAGAATGTATCA -> TACAGCAAAGAATGTATCAT
TACAGCAAAGAATGTATCAT -> ACAGCAAAGAATGTATCATG
ACAGCAAAGAATGTATCATG -> CAGCAAAGAATGTATCATGC
CAGCAAAGAATGTATCATGC -> AGCAAAGAATGTATCATGCG
AGCAAAGAATGTATCATGCG -> GCAAAGAATGTATCATGCGT
GCAAAGAATGTATCATGCGT -> CAAAGAATGTATCATGCGTA
CAAAGAATGTATCATGCGTA -> AAAGAATGTATCATGCGTAG
AAAGAATGTATCATGCGTAG -> AAGAATGTATCATGCGTAGG
AAGAATGTATCATGCGTAGG -> AGAATGTATCATGCGTAGGA
AGAATGTATCATGCGTAGGA -> GAATGTATCATGCGTAGGAC
GAATGTATCATGCGTAGGAC -> AATGTATCATGCGTAGGACT
AATGTATCATGCGTAGGACT -> ATGTATCATGCGTAGGACTG
ATGTATCATGCGTAGGACTG -> TGTATCATGCGTAGGACTGG
TGTATCATGCGTAGGACTGG -> GTATCATGCGTAGGACTGGC
GTATCATGCGTAGGACTGGC -> TATCATGCGTAGGACTGGCG
TATCATGCGTAGGACTGGCG -> ATCATGCGTAGGACTGGCGT
ATCATGCGTAGGACTGGCGT -> TCATGCGTAGGACTGGCGTA
TCATGCGTAGGACTGGCGTA -> CATGCGTAGGACTGGCGTAT
CATGCGTAGGACTGGCGTAT -> ATGCGTAGGACTGGCGTATC
ATGCGTAGGACTGGCGTATC -> TGCGTAGGACTGGCGTATCT
TGCGTAGGACTGGCGTATCT -> GCGTAGGACTGGCGTATCTA
GCGTAGGACTGGCGTATCTA -> CGTAGGACTGGCGTATCTAC
CGTAGGACTGGCGTATCTAC -> GTAGGACTGGCGTATCTACA
GTAGGACTGGCGTATCTACA -> TAGGACTGGCGTATCTACAT
TAGGACTGGCGTATCTACAT -> AGGACTGGCGTATCTACATA
AGGACTGGCGTATCTACATA -> GGACTGGCGTATCTACATAC
GGACTGGCGTATCTACATAC -> GACTGGCGTATCTACATACA
GACTGGCGTATCTACATACA -> ACTGGCGTATCTACATACAA
ACTGGCGTATCTACATACAA -> CTGGCGTATCTACATACAAA
CTGGCGTATCTACATACAAA -> TGGCGTATCTACATACAAAA
TGGCGTATCTACATACAAAA -> GGCGTATCTACATACAAAAG
GGCGTATCTACATACAAAAG -> GCGTATCTACATACAAAAGT
GCGTATCTACATACAAAAGT -> CGTATCTACATACAAAAGTC
CGTATCTACATACAAAAGTC -> GTATCTACATACAAAAGTCA
GTATCTACATACAAAAGTCA -> TATCTACATACAAAAGTCAT
TATCTACATACAAAAGTCAT -> ATCTACATACAAAAGTCATT
ATCTACATACAAAAGTCATT -> TCTACATACAAAAGTCATTG
TCTACATACAAAAGTCATTG -> CTACATACAAAAGTCATTGC
CTACATACAAAAGTCATTGC -> TACATACAAAAGTCATTGCC
TACATACAAAAGTCATTGCC -> ACATACAAAAGTCATTGCCG
ACATACAAAAGTCATTGCCG -> CATACAAAAGTCATTGCCGG
CATACAAAAGTCATTGCCGG -> ATACAAAAGTCATTGCCGGC
ATACAAAAGTCATTGCCGGC -> TACAAAAGTCATTGCCGGCG
TACAAAAGTCATTGCCGGCG -> ACAAAAGTCATTGCCGGCGA
ACAAAAGTCATTGCCGGCGA -> CAAAAGTCATTGCCGGCGAA
CAAAAGTCATTGCCGGCGAA -> AAAAGTCATTGCCGGCGAAA
AAAAGTCATTGCCGGCGAAA -> AAAGTCATTGCCGGCGAAAC
AAAGTCATTGCCGGCGAAAC -> AAGTCATTGCCGGCGAAACC
AAGTCATTGCCGGCGAAACC -> AGTCATTGCCGGCGAAACCT
AGTCATTGCCGGCGAAACCT -> GTCATTGCCGGCGAAACCTA
GTCATTGCCGGCGAAACCTA -> TCATTGCCGGCGAAACCTAC
TCATTGCCGGCGAAACCTAC -> CATTGCCGGCGAAACCTACA
CATTGCCGGCGAAACCTACA -> ATTGCCGGCGAAACCTACAT
ATTGCCGGCGAAACCTACAT -> TTGCCGGCGAAACCTACATC
TTGCCGGCGAAACCTACATC -> TGCCGGCGAAACCTACATCA
TGCCGGCGAAACCTACATCA -> GCCGGCGAAACCTACATCAT
GCCGGCGAAACCTACATCAT -> CCGGCGAAACCTACATCATT
CCGGCGAAACCTACATCATT -> CGGCGAAACCTACATCATTT
CGGCGAAACCTACATCATTT -> GGCGAAACCTACATCATTTG
GGCGAAACCTACATCATTTG -> GCGAAACCTACATCATTTGC
GCGAAACCTACATCATTTGC -> CGAAACCTACATCATTTGCG
CGAAACCTACATCATTTGCG -> GAAACCTACATCATTTGCGA
GAAACCTACATCATTTGCGA -> AAACCTACATCATTTGCGAC
AAACCTACATCATTTGCGAC -> AACCTACATCATTTGCGACG
AACCTACATCATTTGCGACG -> ACCTACATCATTTGCGACGT
ACCTACATCATTTGCGACGT -> CCTACATCATTTGCGACGTT
CCTACATCATTTGCGACGTT -> CTACATCATTTGCGACGTTC
CTACATCATTTGCGACGTTC -> TACATCATTTGCGACGTTCA
TACATCATTTGCGACGTTCA -> ACATCATTTGCGACGTTCAG
ACATCATTTGCGACGTTCAG -> CATCATTTGCGACGTTCAGT
CATCATTTGCGACGTTCAGT -> ATCATTTGCGACGTTCAGTC
ATCATTTGCGACGTTCAGTC -> TCATTTGCGACGTTCAGTCC
TCATTTGCGACGTTCAGTCC -> CATTTGCGACGTTCAGTCCG
CATTTGCGACGTTCAGTCCG -> ATTTGCGACGTTCAGTCCGT
ATTTGCGACGTTCAGTCCGT -> TTTGCGACGTTCAGTCCGTC
TTTGCGACGTTCAGTCCGTC -> TTGCGACGTTCAGTCCGTCT
TTGCGACGTTCAGTCCGTCT -> TGCGACGTTCAGTCCGTCTG
TGCGACGTTCAGTCCGTCTG -> GCGACGTTCAGTCCGTCTGA
GCGACGTTCAGTCCGTCTGA -> CGACGTTCAGTCCGTCTGAC
CGACGTTCAGTCCGTCTGAC -> GACGTTCAGTCCGTCTGACT
GACGTTCAGTCCGTCTGACT -> ACGTTCAGTCCGTCTGACTG
ACGTTCAGTCCGTCTGACTG -> CGTTCAGTCCGTCTGACTGC
CGTTCAGTCCGTCTGACTGC -> GTTCAGTCCGTCTGACTGCG
GTTCAGTCCGTCTGACTGCG -> TTCAGTCCGTCTGACTGCGG
TTCAGTCCGTCTGACTGCGG -> TCAGTCCGTCTGACTGCGGT
TCAGTCCGTCTGACTGCGGT -> CAGTCCGTCTGACTGCGGTC
CAGTCCGTCTGACTGCGGTC -> AGTCCGTCTGACTGCGGTCA
AGTCCGTCTGACTGCGGTCA -> GTCCGTCTGACTGCGGTCAG
GTCCGTCTGACTGCGGTCAG -> TCCGTCTGACTGCGGTCAGT
TCCGTCTGACTGCGGTCAGT -> CCGTCTGACTGCGGTCAGTT
CCGTCTGACTGCGGTCAGTT -> CGTCTGACTGCGGTCAGTTG
CGTCTGACTGCGGTCAGTTG -> GTCTGACTGCGGTCAGTTGA
GTCTGACTGCGGTCAGTTGA -> TCTGACTGCGGTCAGTTGAT
TCTGACTGCGGTCAGTTGAT -> CTGACTGCGGTCAGTTGATA
CTGACTGCGGTCAGTTGATA -> TGACTGCGGTCAGTTGATAT
TGACTGCGGTCAGTTGATAT -> GACTGCGGTCAGTTGATATC
GACTGCGGTCAGTTGATATC -> ACTGCGGTCAGTTGATATCA
ACTGCGGTCAGTTGATATCA -> CTGCGGTCAGTTGATATCAT
CTGCGGTCAGTTGATATCAT -> TGCGGTCAGTTGATATCATC
TGCGGTCAGTTGATATCATC -> GCGGTCAGTTGATATCATCC
GCGGTCAGTTGATATCATCC -> CGGTCAGTTGATATCATCCA
CGGTCAGTTGATATCATCCA -> GGTCAGTTGATATCATCCAA
GGTCAGTTGATATCATCCAA -> GTCAGTTGATATCATCCAAC
GTCAGTTGATATCATCCAAC -> TCAGTTGATATCATCCAACA
TCAGTTGATATCATCCAACA -> CAGTTGATATCATCCAACAG
CAGTTGATATCATCCAACAG -> AGTTGATATCATCCAACAGT
AGTTGATATCATCCAACAGT -> GTTGATATCATCCAACAGTT
GTTGATATCATCCAACAGTT -> TTGATATCATCCAACAGTTA
TTGATATCATCCAACAGTTA -> TGATATCATCCAACAGTTAC
TGATATCATCCAACAGTTAC -> GATATCATCCAACAGTTACA
GATATCATCCAACAGTTACA -> ATATCATCCAACAGTTACAT
ATATCATCCAACAGTTACAT -> TATCATCCAACAGTTACATA
TATCATCCAACAGTTACATA -> ATCATCCAACAGTTACATAT
ATCATCCAACAGTTACATAT -> TCATCCAACAGTTACATATA
TCATCCAACAGTTACATATA -> CATCCAACAGTTACATATAC
CATCCAACAGTTACATATAC -> ATCCAACAGTTACATATACC
ATCCAACAGTTACATATACC -> TCCAACAGTTACATATACCT
TCCAACAGTTACATATACCT -> CCAACAGTTACATATACCTC
CCAACAGTTACATATACCTC -> CAACAGTTACATATACCTCC
CAACAGTTACATATACCTCC -> AACAGTTACATATACCTCCT
AACAGTTACATATACCTCCT -> ACAGTTACATATACCTCCTC
ACAGTTACATATACCTCCTC -> CAGTTACATATACCTCCTCA
CAGTTACATATACCTCCTCA -> AGTTACATATACCTCCTCAA
AGTTACATATACCTCCTCAA -> GTTACATATACCTCCTCAAG
GTTACATATACCTCCTCAAG -> TTACATATACCTCCTCAAGC
TTACATATACCTCCTCAAGC -> TACATATACCTCCTCAAGCA
TACATATACCTCCTCAAGCA -> ACATATACCTCCTCAAGCAT
ACATATACCTCCTCAAGCAT -> CATATACCTCCTCAAGCATA
CATATACCTCCTCAAGCATA -> ATATACCTCCTCAAGCATAC
ATATACCTCCTCAAGCATAC -> TATACCTCCTCAAGCATACA
TATACCTCCTCAAGCATACA -> ATACCTCCTCAAGCATACAG
ATACCTCCTCAAGCATACAG -> TACCTCCTCAAGCATACAGG
TACCTCCTCAAGCATACAGG -> ACCTCCTCAAGCATACAGGC
ACCTCCTCAAGCATACAGGC -> CCTCCTCAAGCATACAGGCT
CCTCCTCAAGCATACAGGCT -> CTCCTCAAGCATACAGGCTA
CTCCTCAAGCATACAGGCTA -> TCCTCAAGCATACAGGCTAG
TCCTCAAGCATACAGGCTAG -> CCTCAAGCATACAGGCTAGT
CCTCAAGCATACAGGCTAGT -> CTCAAGCATACAGGCTAGTG
CTCAAGCATACAGGCTAGTG -> TCAAGCATACAGGCTAGTGA
TCAAGCATACAGGCTAGTGA -> CAAGCATACAGGCTAGTGAA
CAAGCATACAGGCTAGTGAA -> AAGCATACAGGCTAGTGAAC
AAGCATACAGGCTAGTGAAC -> AGCATACAGGCTAGTGAACG
AGCATACAGGCTAGTGAACG -> GCATACAGGCTAGTGAACGC
GCATACAGGCTAGTGAACGC -> CATACAGGCTAGTGAACGCG
CATACAGGCTAGTGAACGCG -> ATACAGGCTAGTGAACGCGG
ATACAGGCTAGTGAACGCGG -> TACAGGCTAGTGAACGCGGC
TACAGGCTAGTGAACGCGGC -> ACAGGCTAGTGAACGCGGCA
ACAGGCTAGTGAACGCGGCA -> CAGGCTAGTGAACGCGGCAA
CAGGCTAGTGAACGCGGCAA -> AGGCTAGTGAACGCGGCAAG
AGGCTAGTGAACGCGGCAAG -> GGCTAGTGAACGCGGCAAGA
GGCTAGTGAACGCGGCAAGA -> GCTAGTGAACGCGGCAAGAA
GCTAGTGAACGCGGCAAGAA -> CTAGTGAACGCGGCAAGAAG
CTAGTGAACGCGGCAAGAAG -> TAGTGAACGCGGCAAGAAGT
TAGTGAACGCGGCAAGAAGT -> AGTGAACGCGGCAAGAAGTG
AGTGAACGCGGCAAGAAGTG -> GTGAACGCGGCAAGAAGTGT
GTGAACGCGGCAAGAAGTGT -> TGAACGCGGCAAGAAGTGTG
TGAACGCGGCAAGAAGTGTG -> GAACGCGGCAAGAAGTGTGC
GAACGCGGCAAGAAGTGTGC -> AACGCGGCAAGAAGTGTGCG
AACGCGGCAAGAAGTGTGCG -> ACGCGGCAAGAAGTGTGCGT
ACGCGGCAAGAAGTGTGCGT -> CGCGGCAAGAAGTGTGCGTA
CGCGGCAAGAAGTGTGCGTA -> GCGGCAAGAAGTGTGCGTAG
GCGGCAAGAAGTGTGCGTAG -> CGGCAAGAAGTGTGCGTAGA
CGGCAAGAAGTGTGCGTAGA -> GGCAAGAAGTGTGCGTAGAT
GGCAAGAAGTGTGCGTAGAT -> GCAAGAAGTGTGCGTAGATT
GCAAGAAGTGTGCGTAGATT -> CAAGAAGTGTGCGTAGATTG
CAAGAAGTGTGCGTAGATTG -> AAGAAGTGTGCGTAGATTGT
AAGAAGTGTGCGTAGATTGT -> AGAAGTGTGCGTAGATTGTA
AGAAGTGTGCGTAGATTGTA -> GAAGTGTGCGTAGATTGTAC
GAAGTGTGCGTAGATTGTAC -> AAGTGTGCGTAGATTGTACT
AAGTGTGCGTAGATTGTACT -> AGTGTGCGTAGATTGTACTC
AGTGTGCGTAGATTGTACTC -> GTGTGCGTAGATTGTACTCA
GTGTGCGTAGATTGTACTCA -> TGTGCGTAGATTGTACTCAT
TGTGCGTAGATTGTACTCAT -> GTGCGTAGATTGTACTCATT
GTGCGTAGATTGTACTCATT -> TGCGTAGATTGTACTCATTT
TGCGTAGATTGTACTCATTT -> GCGTAGATTGTACTCATTTA
GCGTAGATTGTACTCATTTA -> CGTAGATTGTACTCATTTAG
CGTAGATTGTACTCATTTAG -> GTAGATTGTACTCATTTAGC
GTAGATTGTACTCATTTAGC -> TAGATTGTACTCATTTAGCG
TAGATTGTACTCATTTAGCG -> AGATTGTACTCATTTAGCGG
AGATTGTACTCATTTAGCGG -> GATTGTACTCATTTAGCGGT
GATTGTACTCATTTAGCGGT -> ATTGTACTCATTTAGCGGTA
ATTGTACTCATTTAGCGGTA -> TTGTACTCATTTAGCGGTAC
TTGTACTCATTTAGCGGTAC -> TGTACTCATTTAGCGGTACT
TGTACTCATTTAGCGGTACT -> GTACTCATTTAGCGGTACTC
GTACTCATTTAGCGGTACTC -> TACTCATTTAGCGGTACTCC
TACTCATTTAGCGGTACTCC -> ACTCATTTAGCGGTACTCCT
ACTCATTTAGCGGTACTCCT -> CTCATTTAGCGGTACTCCTA
CTCATTTAGCGGTACTCCTA -> TCATTTAGCGGTACTCCTAG
TCATTTAGCGGTACTCCTAG -> CATTTAGCGGTACTCCTAGG
CATTTAGCGGTACTCCTAGG -> ATTTAGCGGTACTCCTAGGC
ATTTAGCGGTACTCCTAGGC -> TTTAGCGGTACTCCTAGGCT
TTTAGCGGTACTCCTAGGCT -> TTAGCGGTACTCCTAGGCTA
TTAGCGGTACTCCTAGGCTA -> TAGCGGTACTCCTAGGCTAC
TAGCGGTACTCCTAGGCTAC -> AGCGGTACTCCTAGGCTACA
AGCGGTACTCCTAGGCTACA -> GCGGTACTCCTAGGCTACAA
GCGGTACTCCTAGGCTACAA -> CGGTACTCCTAGGCTACAAC
CGGTACTCCTAGGCTACAAC -> GGTACTCCTAGGCTACAACT
GGTACTCCTAGGCTACAACT -> GTACTCCTAGGCTACAACTT
GTACTCCTAGGCTACAACTT -> TACTCCTAGGCTACAACTTC
TACTCCTAGGCTACAACTTC -> ACTCCTAGGCTACAACTTCT
ACTCCTAGGCTACAACTTCT -> CTCCTAGGCTACAACTTCTC
CTCCTAGGCTACAACTTCTC -> TCCTAGGCTACAACTTCTCC
TCCTAGGCTACAACTTCTCC -> CCTAGGCTACAACTTCTCCT
CCTAGGCTACAACTTCTCCT -> CTAGGCTACAACTTCTCCTA
CTAGGCTACAACTTCTCCTA -> TAGGCTACAACTTCTCCTAC
TAGGCTACAACTTCTCCTAC -> AGGCTACAACTTCTCCTACA
AGGCTACAACTTCTCCTACA -> GGCTACAACTTCTCCTACAT
GGCTACAACTTCTCCTACAT -> GCTACAACTTCTCCTACATT
GCTACAACTTCTCCTACATT -> CTACAACTTCTCCTACATTA
CTACAACTTCTCCTACATTA -> TACAACTTCTCCTACATTAC
TACAACTTCTCCTACATTAC -> ACAACTTCTCCTACATTACT
ACAACTTCTCCTACATTACT -> CAACTTCTCCTACATTACTT
CAACTTCTCCTACATTACTT -> AACTTCTCCTACATTACTTC
AACTTCTCCTACATTACTTC -> ACTTCTCCTACATTACTTCG
ACTTCTCCTACATTACTTCG -> CTTCTCCTACATTACTTCGA
CTTCTCCTACATTACTTCGA -> TTCTCCTACATTACTTCGAG
TTCTCCTACATTACTTCGAG -> TCTCCTACATTACTTCGAGT
TCTCCTACATTACTTCGAGT -> CTCCTACATTACTTCGAGTC
CTCCTACATTACTTCGAGTC -> TCCTACATTACTTCGAGTCG
TCCTACATTACTTCGAGTCG -> CCTACATTACTTCGAGTCGG
CCTACATTACTTCGAGTCGG -> CTACATTACTTCGAGTCGGG
CTACATTACTTCGAGTCGGG -> TACATTACTTCGAGTCGGGG
TACATTACTTCGAGTCGGGG -> ACATTACTTCGAGTCGGGGC
ACATTACTTCGAGTCGGGGC -> CATTACTTCGAGTCGGGGCG
CATTACTTCGAGTCGGGGCG -> ATTACTTCGAGTCGGGGCGC
ATTACTTCGAGTCGGGGCGC -> TTACTTCGAGTCGGGGCGCC
TTACTTCGAGTCGGGGCGCC -> TACTTCGAGTCGGGGCGCCC
TACTTCGAGTCGGGGCGCCC -> ACTTCGAGTCGGGGCGCCCA
ACTTCGAGTCGGGGCGCCCA -> CTTCGAGTCGGGGCGCCCAC
CTTCGAGTCGGGGCGCCCAC -> TTCGAGTCGGGGCGCCCACC
TTCGAGTCGGGGCGCCCACC -> TCGAGTCGGGGCGCCCACCG
TCGAGTCGGGGCGCCCACCG -> CGAGTCGGGGCGCCCACCGT
CGAGTCGGGGCGCCCACCGT -> GAGTCGGGGCGCCCACCGTG
GAGTCGGGGCGCCCACCGTG -> AGTCGGGGCGCCCACCGTGG
AGTCGGGGCGCCCACCGTGG -> GTCGGGGCGCCCACCGTGGC
GTCGGGGCGCCCACCGTGGC -> TCGGGGCGCCCACCGTGGCG
TCGGGGCGCCCACCGTGGCG -> CGGGGCGCCCACCGTGGCGA
CGGGGCGCCCACCGTGGCGA -> GGGGCGCCCACCGTGGCGAC
GGGGCGCCCACCGTGGCGAC -> GGGCGCCCACCGTGGCGACT
GGGCGCCCACCGTGGCGACT -> GGCGCCCACCGTGGCGACTC
GGCGCCCACCGTGGCGACTC -> GCGCCCACCGTGGCGACTCC
GCGCCCACCGTGGCGACTCC -> CGCCCACCGTGGCGACTCCA
CGCCCACCGTGGCGACTCCA -> GCCCACCGTGGCGACTCCAT
GCCCACCGTGGCGACTCCAT -> CCCACCGTGGCGACTCCATA
CCCACCGTGGCGACTCCATA -> CCACCGTGGCGACTCCATAG
CCACCGTGGCGACTCCATAG -> CACCGTGGCGACTCCATAGG
CACCGTGGCGACTCCATAGG -> ACCGTGGCGACTCCATAGGA
ACCGTGGCGACTCCATAGGA -> CCGTGGCGACTCCATAGGAC
CCGTGGCGACTCCATAGGAC -> CGTGGCGACTCCATAGGACC
CGTGGCGACTCCATAGGACC -> GTGGCGACTCCATAGGACCT
GTGGCGACTCCATAGGACCT -> TGGCGACTCCATAGGACCTA
TGGCGACTCCATAGGACCTA -> GGCGACTCCATAGGACCTAT
GGCGACTCCATAGGACCTAT -> GCGACTCCATAGGACCTATC
GCGACTCCATAGGACCTATC -> CGACTCCATAGGACCTATCA
CGACTCCATAGGACCTATCA -> GACTCCATAGGACCTATCAC
GACTCCATAGGACCTATCAC -> ACTCCATAGGACCTATCACA
ACTCCATAGGACCTATCACA -> CTCCATAGGACCTATCACAC
CTCCATAGGACCTATCACAC -> TCCATAGGACCTATCACACC
TCCATAGGACCTATCACACC -> CCATAGGACCTATCACACCG
CCATAGGACCTATCACACCG -> CATAGGACCTATCACACCGT
CATAGGACCTATCACACCGT -> ATAGGACCTATCACACCGTT
ATAGGACCTATCACACCGTT -> TAGGACCTATCACACCGTTT
TAGGACCTATCACACCGTTT -> AGGACCTATCACACCGTTTC
AGGACCTATCACACCGTTTC -> GGACCTATCACACCGTTTCC
GGACCTATCACACCGTTTCC -> GACCTATCACACCGTTTCCT
GACCTATCACACCGTTTCCT -> ACCTATCACACCGTTTCCTC
ACCTATCACACCGTTTCCTC -> CCTATCACACCGTTTCCTCC
CCTATCACACCGTTTCCTCC -> CTATCACACCGTTTCCTCCT
CTATCACACCGTTTCCTCCT -> TATCACACCGTTTCCTCCTC
TATCACACCGTTTCCTCCTC -> ATCACACCGTTTCCTCCTCA
ATCACACCGTTTCCTCCTCA -> TCACACCGTTTCCTCCTCAA
TCACACCGTTTCCTCCTCAA -> CACACCGTTTCCTCCTCAAC
CACACCGTTTCCTCCTCAAC -> ACACCGTTTCCTCCTCAACA
ACACCGTTTCCTCCTCAACA -> CACCGTTTCCTCCTCAACAA
CACCGTTTCCTCCTCAACAA -> ACCGTTTCCTCCTCAACAAT
ACCGTTTCCTCCTCAACAAT -> CCGTTTCCTCCTCAACAATC
CCGTTTCCTCCTCAACAATC -> CGTTTCCTCCTCAACAATCA
CGTTTCCTCCTCAACAATCA -> GTTTCCTCCTCAACAATCAG
GTTTCCTCCTCAACAATCAG -> TTTCCTCCTCAACAATCAGT
TTTCCTCCTCAACAATCAGT -> TTCCTCCTCAACAATCAGTC
TTCCTCCTCAACAATCAGTC -> TCCTCCTCAACAATCAGTCT
TCCTCCTCAACAATCAGTCT -> CCTCCTCAACAATCAGTCTG
CCTCCTCAACAATCAGTCTG -> CTCCTCAACAATCAGTCTGT
CTCCTCAACAATCAGTCTGT -> TCCTCAACAATCAGTCTGTG
TCCTCAACAATCAGTCTGTG -> CCTCAACAATCAGTCTGTGA
CCTCAACAATCAGTCTGTGA -> CTCAACAATCAGTCTGTGAC
CTCAACAATCAGTCTGTGAC -> TCAACAATCAGTCTGTGACG
TCAACAATCAGTCTGTGACG -> CAACAATCAGTCTGTGACGT
CAACAATCAGTCTGTGACGT -> AACAATCAGTCTGTGACGTG
AACAATCAGTCTGTGACGTG -> ACAATCAGTCTGTGACGTGC
ACAATCAGTCTGTGACGTGC -> CAATCAGTCTGTGACGTGCT
CAATCAGTCTGTGACGTGCT -> AATCAGTCTGTGACGTGCTA
AATCAGTCTGTGACGTGCTA -> ATCAGTCTGTGACGTGCTAC
ATCAGTCTGTGACGTGCTAC -> TCAGTCTGTGACGTGCTACA
TCAGTCTGTGACGTGCTACA -> CAGTCTGTGACGTGCTACAT
CAGTCTGTGACGTGCTACAT -> AGTCTGTGACGTGCTACATC
AGTCTGTGACGTGCTACATC -> GTCTGTGACGTGCTACATCA
GTCTGTGACGTGCTACATCA -> TCTGTGACGTGCTACATCAG
TCTGTGACGTGCTACATCAG -> CTGTGACGTGCTACATCAGC
CTGTGACGTGCTACATCAGC -> TGTGACGTGCTACATCAGCT
TGTGACGTGCTACATCAGCT -> GTGACGTGCTACATCAGCTT
GTGACGTGCTACATCAGCTT -> TGACGTGCTACATCAGCTTC
TGACGTGCTACATCAGCTTC -> GACGTGCTACATCAGCTTCA
GACGTGCTACATCAGCTTCA -> ACGTGCTACATCAGCTTCAA
ACGTGCTACATCAGCTTCAA -> CGTGCTACATCAGCTTCAAG
CGTGCTACATCAGCTTCAAG -> GTGCTACATCAGCTTCAAGT
GTGCTACATCAGCTTCAAGT -> TGCTACATCAGCTTCAAGTG
TGCTACATCAGCTTCAAGTG -> GCTACATCAGCTTCAAGTGC
GCTACATCAGCTTCAAGTGC -> CTACATCAGCTTCAAGTGCT
CTACATCAGCTTCAAGTGCT -> TACATCAGCTTCAAGTGCTC
TACATCAGCTTCAAGTGCTC -> ACATCAGCTTCAAGTGCTCG
ACATCAGCTTCAAGTGCTCG -> CATCAGCTTCAAGTGCTCGC
CATCAGCTTCAAGTGCTCGC -> ATCAGCTTCAAGTGCTCGCG
ATCAGCTTCAAGTGCTCGCG -> TCAGCTTCAAGTGCTCGCGC
TCAGCTTCAAGTGCTCGCGC -> CAGCTTCAAGTGCTCGCGCT
CAGCTTCAAGTGCTCGCGCT -> AGCTTCAAGTGCTCGCGCTG
AGCTTCAAGTGCTCGCGCTG -> GCTTCAAGTGCTCGCGCTGC
GCTTCAAGTGCTCGCGCTGC -> CTTCAAGTGCTCGCGCTGCC
CTTCAAGTGCTCGCGCTGCC -> TTCAAGTGCTCGCGCTGCCT
TTCAAGTGCTCGCGCTGCCT -> TCAAGTGCTCGCGCTGCCTA
TCAAGTGCTCGCGCTGCCTA -> CAAGTGCTCGCGCTGCCTAA
CAAGTGCTCGCGCTGCCTAA -> AAGTGCTCGCGCTGCCTAAA
AAGTGCTCGCGCTGCCTAAA -> AGTGCTCGCGCTGCCTAAAA
AGTGCTCGCGCTGCCTAAAA -> GTGCTCGCGCTGCCTAAAAC
GTGCTCGCGCTGCCTAAAAC -> TGCTCGCGCTGCCTAAAACG
TGCTCGCGCTGCCTAAAACG -> GCTCGCGCTGCCTAAAACGT
GCTCGCGCTGCCTAAAACGT -> CTCGCGCTGCCTAAAACGTC
CTCGCGCTGCCTAAAACGTC -> TCGCGCTGCCTAAAACGTCC
TCGCGCTGCCTAAAACGTCC -> CGCGCTGCCTAAAACGTCCT
CGCGCTGCCTAAAACGTCCT -> GCGCTGCCTAAAACGTCCTC
GCGCTGCCTAAAACGTCCTC -> CGCTGCCTAAAACGTCCTCT
CGCTGCCTAAAACGTCCTCT -> GCTGCCTAAAACGTCCTCTC
GCTGCCTAAAACGTCCTCTC -> CTGCCTAAAACGTCCTCTCC
CTGCCTAAAACGTCCTCTCC -> TGCCTAAAACGTCCTCTCCT
TGCCTAAAACGTCCTCTCCT -> GCCTAAAACGTCCTCTCCTC
GCCTAAAACGTCCTCTCCTC -> CCTAAAACGTCCTCTCCTCC
CCTAAAACGTCCTCTCCTCC -> CTAAAACGTCCTCTCCTCCT
CTAAAACGTCCTCTCCTCCT -> TAAAACGTCCTCTCCTCCTT
TAAAACGTCCTCTCCTCCTT -> AAAACGTCCTCTCCTCCTTC
AAAACGTCCTCTCCTCCTTC -> AAACGTCCTCTCCTCCTTCT
AAACGTCCTCTCCTCCTTCT -> AACGTCCTCTCCTCCTTCTT
AACGTCCTCTCCTCCTTCTT -> ACGTCCTCTCCTCCTTCTTT
ACGTCCTCTCCTCCTTCTTT -> CGTCCTCTCCTCCTTCTTTC
CGTCCTCTCCTCCTTCTTTC -> GTCCTCTCCTCCTTCTTTCA
GTCCTCTCCTCCTTCTTTCA -> TCCTCTCCTCCTTCTTTCAC
TCCTCTCCTCCTTCTTTCAC -> CCTCTCCTCCTTCTTTCACC
CCTCTCCTCCTTCTTTCACC -> CTCTCCTCCTTCTTTCACCG
CTCTCCTCCTTCTTTCACCG -> TCTCCTCCTTCTTTCACCGG
TCTCCTCCTTCTTTCACCGG -> CTCCTCCTTCTTTCACCGGG
CTCCTCCTTCTTTCACCGGG -> TCCTCCTTCTTTCACCGGGC
TCCTCCTTCTTTCACCGGGC -> CCTCCTTCTTTCACCGGGCA
CCTCCTTCTTTCACCGGGCA -> CTCCTTCTTTCACCGGGCAC
CTCCTTCTTTCACCGGGCAC -> TCCTTCTTTCACCGGGCACC
TCCTTCTTTCACCGGGCACC -> CCTTCTTTCACCGGGCACCG
CCTTCTTTCACCGGGCACCG -> CTTCTTTCACCGGGCACCGG
CTTCTTTCACCGGGCACCGG -> TTCTTTCACCGGGCACCGGT
TTCTTTCACCGGGCACCGGT -> TCTTTCACCGGGCACCGGTC
TCTTTCACCGGGCACCGGTC -> CTTTCACCGGGCACCGGTCG
CTTTCACCGGGCACCGGTCG -> TTTCACCGGGCACCGGTCGA
TTTCACCGGGCACCGGTCGA -> TTCACCGGGCACCGGTCGAT
TTCACCGGGCACCGGTCGAT -> TCACCGGGCACCGGTCGATC
TCACCGGGCACCGGTCGATC -> CACCGGGCACCGGTCGATCG
CACCGGGCACCGGTCGATCG -> ACCGGGCACCGGTCGATCGC
ACCGGGCACCGGTCGATCGC -> CCGGGCACCGGTCGATCGCT
CCGGGCACCGGTCGATCGCT -> CGGGCACCGGTCGATCGCTA
CGGGCACCGGTCGATCGCTA -> GGGCACCGGTCGATCGCTAT
GGGCACCGGTCGATCGCTAT -> GGCACCGGTCGATCGCTATA
GGCACCGGTCGATCGCTATA -> GCACCGGTCGATCGCTATAT
GCACCGGTCGATCGCTATAT -> CACCGGTCGATCGCTATATC
CACCGGTCGATCGCTATATC -> ACCGGTCGATCGCTATATCC
ACCGGTCGATCGCTATATCC -> CCGGTCGATCGCTATATCCT
CCGGTCGATCGCTATATCCT -> CGGTCGATCGCTATATCCTG
CGGTCGATCGCTATATCCTG -> GGTCGATCGCTATATCCTGC
GGTCGATCGCTATATCCTGC -> GTCGATCGCTATATCCTGCT
GTCGATCGCTATATCCTGCT -> TCGATCGCTATATCCTGCTT
TCGATCGCTATATCCTGCTT -> CGATCGCTATATCCTGCTTT
CGATCGCTATATCCTGCTTT -> GATCGCTATATCCTGCTTTT
GATCGCTATATCCTGCTTTT -> ATCGCTATATCCTGCTTTTA
ATCGCTATATCCTGCTTTTA -> TCGCTATATCCTGCTTTTAC
TCGCTATATCCTGCTTTTAC -> CGCTATATCCTGCTTTTACC
CGCTATATCCTGCTTTTACC -> GCTATATCCTGCTTTTACCT
GCTATATCCTGCTTTTACCT -> CTATATCCTGCTTTTACCTT
CTATATCCTGCTTTTACCTT -> TATATCCTGCTTTTACCTTA
TATATCCTGCTTTTACCTTA -> ATATCCTGCTTTTACCTTAA
ATATCCTGCTTTTACCTTAA -> TATCCTGCTTTTACCTTAAA
TATCCTGCTTTTACCTTAAA -> ATCCTGCTTTTACCTTAAAG
ATCCTGCTTTTACCTTAAAG -> TCCTGCTTTTACCTTAAAGC
TCCTGCTTTTACCTTAAAGC -> CCTGCTTTTACCTTAAAGCT
CCTGCTTTTACCTTAAAGCT -> CTGCTTTTACCTTAAAGCTT
CTGCTTTTACCTTAAAGCTT -> TGCTTTTACCTTAAAGCTTC
TGCTTTTACCTTAAAGCTTC -> GCTTTTACCTTAAAGCTTCG
GCTTTTACCTTAAAGCTTCG -> CTTTTACCTTAAAGCTTCGC
CTTTTACCTTAAAGCTTCGC -> TTTTACCTTAAAGCTTCGCG
TTTTACCTTAAAGCTTCGCG -> TTTACCTTAAAGCTTCGCGA
TTTACCTTAAAGCTTCGCGA -> TTACCTTAAAGCTTCGCGAA
TTACCTTAAAGCTTCGCGAA -> TACCTTAAAGCTTCGCGAAT
TACCTTAAAGCTTCGCGAAT -> ACCTTAAAGCTTCGCGAATA
ACCTTAAAGCTTCGCGAATA -> CCTTAAAGCTTCGCGAATAT
CCTTAAAGCTTCGCGAATAT -> CTTAAAGCTTCGCGAATATG
CTTAAAGCTTCGCGAATATG -> TTAAAGCTTCGCGAATATGA
TTAAAGCTTCGCGAATATGA -> TAAAGCTTCGCGAATATGAT
TAAAGCTTCGCGAATATGAT -> AAAGCTTCGCGAATATGATA
AAAGCTTCGCGAATATGATA -> AAGCTTCGCGAATATGATAT
AAGCTTCGCGAATATGATAT -> AGCTTCGCGAATATGATATG
AGCTTCGCGAATATGATATG -> GCTTCGCGAATATGATATGC
GCTTCGCGAATATGATATGC -> CTTCGCGAATATGATATGCT
CTTCGCGAATATGATATGCT -> TTCGCGAATATGATATGCTC
TTCGCGAATATGATATGCTC -> TCGCGAATATGATATGCTCT
TCGCGAATATGATATGCTCT -> CGCGAATATGATATGCTCTA
CGCGAATATGATATGCTCTA -> GCGAATATGATATGCTCTAC
GCGAATATGATATGCTCTAC -> CGAATATGATATGCTCTACC
CGAATATGATATGCTCTACC -> GAATATGATATGCTCTACCG
GAATATGATATGCTCTACCG -> AATATGATATGCTCTACCGA
AATATGATATGCTCTACCGA -> ATATGATATGCTCTACCGAA
ATATGATATGCTCTACCGAA -> TATGATATGCTCTACCGAAT
TATGATATGCTCTACCGAAT -> ATGATATGCTCTACCGAATC
ATGATATGCTCTACCGAATC -> TGATATGCTCTACCGAATCG
TGATATGCTCTACCGAATCG -> GATATGCTCTACCGAATCGA
GATATGCTCTACCGAATCGA -> ATATGCTCTACCGAATCGAC
ATATGCTCTACCGAATCGAC -> TATGCTCTACCGAATCGACA
TATGCTCTACCGAATCGACA -> ATGCTCTACCGAATCGACAA
ATGCTCTACCGAATCGACAA -> TGCTCTACCGAATCGACAAG
TGCTCTACCGAATCGACAAG -> GCTCTACCGAATCGACAAGA
GCTCTACCGAATCGACAAGA -> CTCTACCGAATCGACAAGAC
CTCTACCGAATCGACAAGAC -> TCTACCGAATCGACAAGACA
TCTACCGAATCGACAAGACA -> CTACCGAATCGACAAGACAG
CTACCGAATCGACAAGACAG -> TACCGAATCGACAAGACAGA
TACCGAATCGACAAGACAGA -> ACCGAATCGACAAGACAGAA
ACCGAATCGACAAGACAGAA -> CCGAATCGACAAGACAGAAT
CCGAATCGACAAGACAGAAT -> CGAATCGACAAGACAGAATA
CGAATCGACAAGACAGAATA -> GAATCGACAAGACAGAATAC
GAATCGACAAGACAGAATAC -> AATCGACAAGACAGAATACG
AATCGACAAGACAGAATACG -> ATCGACAAGACAGAATACGC
ATCGACAAGACAGAATACGC -> TCGACAAGACAGAATACGCA
TCGACAAGACAGAATACGCA -> CGACAAGACAGAATACGCAG
CGACAAGACAGAATACGCAG -> GACAAGACAGAATACGCAGG
GACAAGACAGAATACGCAGG -> ACAAGACAGAATACGCAGGT
ACAAGACAGAATACGCAGGT -> CAAGACAGAATACGCAGGTT
CAAGACAGAATACGCAGGTT -> AAGACAGAATACGCAGGTTC
AAGACAGAATACGCAGGTTC -> AGACAGAATACGCAGGTTCC
AGACAGAATACGCAGGTTCC -> GACAGAATACGCAGGTTCCT
GACAGAATACGCAGGTTCCT -> ACAGAATACGCAGGTTCCTC
ACAGAATACGCAGGTTCCTC -> CAGAATACGCAGGTTCCTCT
CAGAATACGCAGGTTCCTCT -> AGAATACGCAGGTTCCTCTC
AGAATACGCAGGTTCCTCTC -> GAATACGCAGGTTCCTCTCG
GAATACGCAGGTTCCTCTCG -> AATACGCAGGTTCCTCTCGA
AATACGCAGGTTCCTCTCGA -> ATACGCAGGTTCCTCTCGAC
ATACGCAGGTTCCTCTCGAC -> TACGCAGGTTCCTCTCGACC
TACGCAGGTTCCTCTCGACC -> ACGCAGGTTCCTCTCGACCG
ACGCAGGTTCCTCTCGACCG -> CGCAGGTTCCTCTCGACCGC
CGCAGGTTCCTCTCGACCGC -> GCAGGTTCCTCTCGACCGCA
GCAGGTTCCTCTCGACCGCA -> CAGGTTCCTCTCGACCGCAA
CAGGTTCCTCTCGACCGCAA -> AGGTTCCTCTCGACCGCAAT
AGGTTCCTCTCGACCGCAAT -> GGTTCCTCTCGACCGCAATC
GGTTCCTCTCGACCGCAATC -> GTTCCTCTCGACCGCAATCG
GTTCCTCTCGACCGCAATCG -> TTCCTCTCGACCGCAATCGG
TTCCTCTCGACCGCAATCGG -> TCCTCTCGACCGCAATCGGA
TCCTCTCGACCGCAATCGGA -> CCTCTCGACCGCAATCGGAT
CCTCTCGACCGCAATCGGAT -> CTCTCGACCGCAATCGGATT
CTCTCGACCGCAATCGGATT -> TCTCGACCGCAATCGGATTG
TCTCGACCGCAATCGGATTG -> CTCGACCGCAATCGGATTGC
CTCGACCGCAATCGGATTGC -> TCGACCGCAATCGGATTGCA
TCGACCGCAATCGGATTGCA -> CGACCGCAATCGGATTGCAC
CGACCGCAATCGGATTGCAC -> GACCGCAATCGGATTGCACC
GACCGCAATCGGATTGCACC -> ACCGCAATCGGATTGCACCC
ACCGCAATCGGATTGCACCC -> CCGCAATCGGATTGCACCCC
CCGCAATCGGATTGCACCCC -> CGCAATCGGATTGCACCCCG
CGCAATCGGATTGCACCCCG -> GCAATCGGATTGCACCCCGA
GCAATCGGATTGCACCCCGA -> CAATCGGATTGCACCCCGAG
CAATCGGATTGCACCCCGAG -> AATCGGATTGCACCCCGAGA
AATCGGATTGCACCCCGAGA -> ATCGGATTGCACCCCGAGAT
ATCGGATTGCACCCCGAGAT -> TCGGATTGCACCCCGAGATG
TCGGATTGCACCCCGAGATG -> CGGATTGCACCCCGAGATGG
CGGATTGCACCCCGAGATGG -> GGATTGCACCCCGAGATGGT
GGATTGCACCCCGAGATGGT -> GATTGCACCCCGAGATGGTG
GATTGCACCCCGAGATGGTG -> ATTGCACCCCGAGATGGTGT
ATTGCACCCCGAGATGGTGT -> TTGCACCCCGAGATGGTGTA
TTGCACCCCGAGATGGTGTA -> TGCACCCCGAGATGGTGTAG
TGCACCCCGAGATGGTGTAG -> GCACCCCGAGATGGTGTAGC
GCACCCCGAGATGGTGTAGC -> CACCCCGAGATGGTGTAGCG
CACCCCGAGATGGTGTAGCG -> ACCCCGAGATGGTGTAGCGA
ACCCCGAGATGGTGTAGCGA -> CCCCGAGATGGTGTAGCGAT
CCCCGAGATGGTGTAGCGAT -> CCCGAGATGGTGTAGCGATC
CCCGAGATGGTGTAGCGATC -> CCGAGATGGTGTAGCGATCA
CCGAGATGGTGTAGCGATCA -> CGAGATGGTGTAGCGATCAG
CGAGATGGTGTAGCGATCAG -> GAGATGGTGTAGCGATCAGG
GAGATGGTGTAGCGATCAGG -> AGATGGTGTAGCGATCAGGG
AGATGGTGTAGCGATCAGGG -> GATGGTGTAGCGATCAGGGT
GATGGTGTAGCGATCAGGGT -> ATGGTGTAGCGATCAGGGTG
ATGGTGTAGCGATCAGGGTG -> TGGTGTAGCGATCAGGGTGT
TGGTGTAGCGATCAGGGTGT -> GGTGTAGCGATCAGGGTGTA
GGTGTAGCGATCAGGGTGTA -> GTGTAGCGATCAGGGTGTAG
GTGTAGCGATCAGGGTGTAG -> TGTAGCGATCAGGGTGTAGT
TGTAGCGATCAGGGTGTAGT -> GTAGCGATCAGGGTGTAGTA
GTAGCGATCAGGGTGTAGTA -> TAGCGATCAGGGTGTAGTAC
TAGCGATCAGGGTGTAGTAC -> AGCGATCAGGGTGTAGTACT
AGCGATCAGGGTGTAGTACT -> GCGATCAGGGTGTAGTACTT
GCGATCAGGGTGTAGTACTT -> CGATCAGGGTGTAGTACTTC
CGATCAGGGTGTAGTACTTC -> GATCAGGGTGTAGTACTTCG
GATCAGGGTGTAGTACTTCG -> ATCAGGGTGTAGTACTTCGG
ATCAGGGTGTAGTACTTCGG -> TCAGGGTGTAGTACTTCGGT
TCAGGGTGTAGTACTTCGGT -> CAGGGTGTAGTACTTCGGTA
CAGGGTGTAGTACTTCGGTA -> AGGGTGTAGTACTTCGGTAA
AGGGTGTAGTACTTCGGTAA -> GGGTGTAGTACTTCGGTAAC
GGGTGTAGTACTTCGGTAAC -> GGTGTAGTACTTCGGTAACA
GGTGTAGTACTTCGGTAACA -> GTGTAGTACTTCGGTAACAC
GTGTAGTACTTCGGTAACAC -> TGTAGTACTTCGGTAACACA
TGTAGTACTTCGGTAACACA -> GTAGTACTTCGGTAACACAC
GTAGTACTTCGGTAACACAC -> TAGTACTTCGGTAACACACG
TAGTACTTCGGTAACACACG -> AGTACTTCGGTAACACACGA
AGTACTTCGGTAACACACGA -> GTACTTCGGTAACACACGAC
GTACTTCGGTAACACACGAC -> TACTTCGGTAACACACGACT
TACTTCGGTAACACACGACT -> ACTTCGGTAACACACGACTT
ACTTCGGTAACACACGACTT -> CTTCGGTAACACACGACTTG
CTTCGGTAACACACGACTTG -> TTCGGTAACACACGACTTGG
TTCGGTAACACACGACTTGG -> TCGGTAACACACGACTTGGT
TCGGTAACACACGACTTGGT -> CGGTAACACACGACTTGGTT
CGGTAACACACGACTTGGTT -> GGTAACACACGACTTGGTTC
GGTAACACACGACTTGGTTC -> GTAACACACGACTTGGTTCA
GTAACACACGACTTGGTTCA -> TAACACACGACTTGGTTCAG
TAACACACGACTTGGTTCAG -> AACACACGACTTGGTTCAGT
AACACACGACTTGGTTCAGT -> ACACACGACTTGGTTCAGTC
ACACACGACTTGGTTCAGTC -> CACACGACTTGGTTCAGTCG
CACACGACTTGGTTCAGTCG -> ACACGACTTGGTTCAGTCGT
ACACGACTTGGTTCAGTCGT -> CACGACTTGGTTCAGTCGTA
CACGACTTGGTTCAGTCGTA -> ACGACTTGGTTCAGTCGTAG
ACGACTTGGTTCAGTCGTAG -> CGACTTGGTTCAGTCGTAGG
CGACTTGGTTCAGTCGTAGG -> GACTTGGTTCAGTCGTAGGA
GACTTGGTTCAGTCGTAGGA -> ACTTGGTTCAGTCGTAGGAC
ACTTGGTTCAGTCGTAGGAC -> CTTGGTTCAGTCGTAGGACA
CTTGGTTCAGTCGTAGGACA -> TTGGTTCAGTCGTAGGACAA
TTGGTTCAGTCGTAGGACAA -> TGGTTCAGTCGTAGGACAAT
TGGTTCAGTCGTAGGACAAT -> GGTTCAGTCGTAGGACAATC
GGTTCAGTCGTAGGACAATC -> GTTCAGTCGTAGGACAATCA
GTTCAGTCGTAGGACAATCA -> TTCAGTCGTAGGACAATCAT
TTCAGTCGTAGGACAATCAT -> TCAGTCGTAGGACAATCATT
TCAGTCGTAGGACAATCATT -> CAGTCGTAGGACAATCATTC
CAGTCGTAGGACAATCATTC -> AGTCGTAGGACAATCATTCT
AGTCGTAGGACAATCATTCT -> GTCGTAGGACAATCATTCTC
GTCGTAGGACAATCATTCTC -> TCGTAGGACAATCATTCTCA
TCGTAGGACAATCATTCTCA -> CGTAGGACAATCATTCTCAT
CGTAGGACAATCATTCTCAT -> GTAGGACAATCATTCTCATG
GTAGGACAATCATTCTCATG -> TAGGACAATCATTCTCATGT
TAGGACAATCATTCTCATGT -> AGGACAATCATTCTCATGTG
AGGACAATCATTCTCATGTG -> GGACAATCATTCTCATGTGA
GGACAATCATTCTCATGTGA -> GACAATCATTCTCATGTGAG
GACAATCATTCTCATGTGAG -> ACAATCATTCTCATGTGAGG
ACAATCATTCTCATGTGAGG -> CAATCATTCTCATGTGAGGC
CAATCATTCTCATGTGAGGC -> AATCATTCTCATGTGAGGCG
AATCATTCTCATGTGAGGCG -> ATCATTCTCATGTGAGGCGC
ATCATTCTCATGTGAGGCGC -> TCATTCTCATGTGAGGCGCT
TCATTCTCATGTGAGGCGCT -> CATTCTCATGTGAGGCGCTA
CATTCTCATGTGAGGCGCTA -> ATTCTCATGTGAGGCGCTAA
ATTCTCATGTGAGGCGCTAA -> TTCTCATGTGAGGCGCTAAC
TTCTCATGTGAGGCGCTAAC -> TCTCATGTGAGGCGCTAACC
TCTCATGTGAGGCGCTAACC -> CTCATGTGAGGCGCTAACCG
CTCATGTGAGGCGCTAACCG -> TCATGTGAGGCGCTAACCGT
TCATGTGAGGCGCTAACCGT -> CATGTGAGGCGCTAACCGTC
CATGTGAGGCGCTAACCGTC -> ATGTGAGGCGCTAACCGTCT
ATGTGAGGCGCTAACCGTCT -> TGTGAGGCGCTAACCGTCTG
TGTGAGGCGCTAACCGTCTG -> GTGAGGCGCTAACCGTCTGA
GTGAGGCGCTAACCGTCTGA -> TGAGGCGCTAACCGTCTGAC
TGAGGCGCTAACCGTCTGAC -> GAGGCGCTAACCGTCTGACT
GAGGCGCTAACCGTCTGACT -> AGGCGCTAACCGTCTGACTT
AGGCGCTAACCGTCTGACTT -> GGCGCTAACCGTCTGACTTG
GGCGCTAACCGTCTGACTTG -> GCGCTAACCGTCTGACTTGG
GCGCTAACCGTCTGACTTGG -> CGCTAACCGTCTGACTTGGG
CGCTAACCGTCTGACTTGGG -> GCTAACCGTCTGACTTGGGG
GCTAACCGTCTGACTTGGGG -> CTAACCGTCTGACTTGGGGT
CTAACCGTCTGACTTGGGGT -> TAACCGTCTGACTTGGGGTA
TAACCGTCTGACTTGGGGTA -> AACCGTCTGACTTGGGGTAT
AACCGTCTGACTTGGGGTAT -> ACCGTCTGACTTGGGGTATT
ACCGTCTGACTTGGGGTATT -> CCGTCTGACTTGGGGTATTT
CCGTCTGACTTGGGGTATTT -> CGTCTGACTTGGGGTATTTA
CGTCTGACTTGGGGTATTTA -> GTCTGACTTGGGGTATTTAA
GTCTGACTTGGGGTATTTAA -> TCTGACTTGGGGTATTTAAT
TCTGACTTGGGGTATTTAAT -> CTGACTTGGGGTATTTAATC
CTGACTTGGGGTATTTAATC -> TGACTTGGGGTATTTAATCG
TGACTTGGGGTATTTAATCG -> GACTTGGGGTATTTAATCGA
GACTTGGGGTATTTAATCGA -> ACTTGGGGTATTTAATCGAC
ACTTGGGGTATTTAATCGAC -> CTTGGGGTATTTAATCGACT
CTTGGGGTATTTAATCGACT -> TTGGGGTATTTAATCGACTT
TTGGGGTATTTAATCGACTT -> TGGGGTATTTAATCGACTTC
TGGGGTATTTAATCGACTTC -> GGGGTATTTAATCGACTTCC
GGGGTATTTAATCGACTTCC -> GGGTATTTAATCGACTTCCT
GGGTATTTAATCGACTTCCT -> GGTATTTAATCGACTTCCTC
GGTATTTAATCGACTTCCTC -> GTATTTAATCGACTTCCTCG
GTATTTAATCGACTTCCTCG -> TATTTAATCGACTTCCTCGC
TATTTAATCGACTTCCTCGC -> ATTTAATCGACTTCCTCGCC
ATTTAATCGACTTCCTCGCC -> TTTAATCGACTTCCTCGCCC
TTTAATCGACTTCCTCGCCC -> TTAATCGACTTCCTCGCCCC
TTAATCGACTTCCTCGCCCC -> TAATCGACTTCCTCGCCCCT
TAATCGACTTCCTCGCCCCT -> AATCGACTTCCTCGCCCCTC
AATCGACTTCCTCGCCCCTC -> ATCGACTTCCTCGCCCCTCA
ATCGACTTCCTCGCCCCTCA -> TCGACTTCCTCGCCCCTCAG
TCGACTTCCTCGCCCCTCAG -> CGACTTCCTCGCCCCTCAGC
CGACTTCCTCGCCCCTCAGC -> GACTTCCTCGCCCCTCAGCA
GACTTCCTCGCCCCTCAGCA -> ACTTCCTCGCCCCTCAGCAC
ACTTCCTCGCCCCTCAGCAC -> CTTCCTCGCCCCTCAGCACT
CTTCCTCGCCCCTCAGCACT -> TTCCTCGCCCCTCAGCACTC
TTCCTCGCCCCTCAGCACTC -> TCCTCGCCCCTCAGCACTCA
TCCTCGCCCCTCAGCACTCA -> CCTCGCCCCTCAGCACTCAG
CCTCGCCCCTCAGCACTCAG -> CTCGCCCCTCAGCACTCAGT
CTCGCCCCTCAGCACTCAGT -> TCGCCCCTCAGCACTCAGTT
TCGCCCCTCAGCACTCAGTT -> CGCCCCTCAGCACTCAGTTA
CGCCCCTCAGCACTCAGTTA -> GCCCCTCAGCACTCAGTTAA
GCCCCTCAGCACTCAGTTAA -> CCCCTCAGCACTCAGTTAAT
CCCCTCAGCACTCAGTTAAT -> CCCTCAGCACTCAGTTAATT
CCCTCAGCACTCAGTTAATT -> CCTCAGCACTCAGTTAATTG
CCTCAGCACTCAGTTAATTG -> CTCAGCACTCAGTTAATTGT
CTCAGCACTCAGTTAATTGT -> TCAGCACTCAGTTAATTGTA
TCAGCACTCAGTTAATTGTA -> CAGCACTCAGTTAATTGTAA
CAGCACTCAGTTAATTGTAA -> AGCACTCAGTTAATTGTAAG
AGCACTCAGTTAATTGTAAG -> GCACTCAGTTAATTGTAAGC
GCACTCAGTTAATTGTAAGC -> CACTCAGTTAATTGTAAGCT
CACTCAGTTAATTGTAAGCT -> ACTCAGTTAATTGTAAGCTA
ACTCAGTTAATTGTAAGCTA -> CTCAGTTAATTGTAAGCTAG
CTCAGTTAATTGTAAGCTAG -> TCAGTTAATTGTAAGCTAGT
TCAGTTAATTGTAAGCTAGT -> CAGTTAATTGTAAGCTAGTC
CAGTTAATTGTAAGCTAGTC -> AGTTAATTGTAAGCTAGTCC
AGTTAATTGTAAGCTAGTCC -> GTTAATTGTAAGCTAGTCCG
GTTAATTGTAAGCTAGTCCG -> TTAATTGTAAGCTAGTCCGA
TTAATTGTAAGCTAGTCCGA -> TAATTGTAAGCTAGTCCGAC
TAATTGTAAGCTAGTCCGAC -> AATTGTAAGCTAGTCCGACA
AATTGTAAGCTAGTCCGACA -> ATTGTAAGCTAGTCCGACAT
ATTGTAAGCTAGTCCGACAT -> TTGTAAGCTAGTCCGACATT
TTGTAAGCTAGTCCGACATT -> TGTAAGCTAGTCCGACATTT
TGTAAGCTAGTCCGACATTT -> GTAAGCTAGTCCGACATTTC
GTAAGCTAGTCCGACATTTC -> TAAGCTAGTCCGACATTTCA
TAAGCTAGTCCGACATTTCA -> AAGCTAGTCCGACATTTCAA
AAGCTAGTCCGACATTTCAA -> AGCTAGTCCGACATTTCAAA
AGCTAGTCCGACATTTCAAA -> GCTAGTCCGACATTTCAAAC
GCTAGTCCGACATTTCAAAC -> CTAGTCCGACATTTCAAACA
CTAGTCCGACATTTCAAACA -> TAGTCCGACATTTCAAACAT
TAGTCCGACATTTCAAACAT -> AGTCCGACATTTCAAACATT
AGTCCGACATTTCAAACATT -> GTCCGACATTTCAAACATTC
GTCCGACATTTCAAACATTC -> TCCGACATTTCAAACATTCA
TCCGACATTTCAAACATTCA -> CCGACATTTCAAACATTCAT
CCGACATTTCAAACATTCAT -> CGACATTTCAAACATTCATG
CGACATTTCAAACATTCATG -> GACATTTCAAACATTCATGC
GACATTTCAAACATTCATGC -> ACATTTCAAACATTCATGCC
ACATTTCAAACATTCATGCC -> CATTTCAAACATTCATGCCC
CATTTCAAACATTCATGCCC -> ATTTCAAACATTCATGCCCT
ATTTCAAACATTCATGCCCT -> TTTCAAACATTCATGCCCTA
TTTCAAACATTCATGCCCTA -> TTCAAACATTCATGCCCTAG
TTCAAACATTCATGCCCTAG -> TCAAACATTCATGCCCTAGA
TCAAACATTCATGCCCTAGA -> CAAACATTCATGCCCTAGAC
CAAACATTCATGCCCTAGAC -> AAACATTCATGCCCTAGACG
AAACATTCATGCCCTAGACG -> AACATTCATGCCCTAGACGG
AACATTCATGCCCTAGACGG -> ACATTCATGCCCTAGACGGA
ACATTCATGCCCTAGACGGA -> CATTCATGCCCTAGACGGAT
CATTCATGCCCTAGACGGAT -> ATTCATGCCCTAGACGGATC
ATTCATGCCCTAGACGGATC -> TTCATGCCCTAGACGGATCG
TTCATGCCCTAGACGGATCG -> TCATGCCCTAGACGGATCGT
TCATGCCCTAGACGGATCGT -> CATGCCCTAGACGGATCGTG
CATGCCCTAGACGGATCGTG -> ATGCCCTAGACGGATCGTGC
ATGCCCTAGACGGATCGTGC -> TGCCCTAGACGGATCGTGCT
TGCCCTAGACGGATCGTGCT -> GCCCTAGACGGATCGTGCTG
GCCCTAGACGGATCGTGCTG -> CCCTAGACGGATCGTGCTGT
CCCTAGACGGATCGTGCTGT -> CCTAGACGGATCGTGCTGTC
CCTAGACGGATCGTGCTGTC -> CTAGACGGATCGTGCTGTCC
CTAGACGGATCGTGCTGTCC -> TAGACGGATCGTGCTGTCCA
TAGACGGATCGTGCTGTCCA -> AGACGGATCGTGCTGTCCAA
AGACGGATCGTGCTGTCCAA -> GACGGATCGTGCTGTCCAAT
GACGGATCGTGCTGTCCAAT -> ACGGATCGTGCTGTCCAATC
ACGGATCGTGCTGTCCAATC -> CGGATCGTGCTGTCCAATCA
CGGATCGTGCTGTCCAATCA -> GGATCGTGCTGTCCAATCAC
GGATCGTGCTGTCCAATCAC -> GATCGTGCTGTCCAATCACA
GATCGTGCTGTCCAATCACA -> ATCGTGCTGTCCAATCACAC
ATCGTGCTGTCCAATCACAC -> TCGTGCTGTCCAATCACACC
TCGTGCTGTCCAATCACACC -> CGTGCTGTCCAATCACACCG
CGTGCTGTCCAATCACACCG -> GTGCTGTCCAATCACACCGC
GTGCTGTCCAATCACACCGC -> TGCTGTCCAATCACACCGCC
TGCTGTCCAATCACACCGCC -> GCTGTCCAATCACACCGCCG
GCTGTCCAATCACACCGCCG -> CTGTCCAATCACACCGCCGT
CTGTCCAATCACACCGCCGT -> TGTCCAATCACACCGCCGTA
TGTCCAATCACACCGCCGTA -> GTCCAATCACACCGCCGTAA
GTCCAATCACACCGCCGTAA -> TCCAATCACACCGCCGTAAG
TCCAATCACACCGCCGTAAG -> CCAATCACACCGCCGTAAGG
CCAATCACACCGCCGTAAGG -> CAATCACACCGCCGTAAGGC
CAATCACACCGCCGTAAGGC -> AATCACACCGCCGTAAGGCC
AATCACACCGCCGTAAGGCC -> ATCACACCGCCGTAAGGCCG
ATCACACCGCCGTAAGGCCG -> TCACACCGCCGTAAGGCCGA
TCACACCGCCGTAAGGCCGA -> CACACCGCCGTAAGGCCGAT
CACACCGCCGTAAGGCCGAT -> ACACCGCCGTAAGGCCGATT
ACACCGCCGTAAGGCCGATT -> CACCGCCGTAAGGCCGATTA
CACCGCCGTAAGGCCGATTA -> ACCGCCGTAAGGCCGATTAC
ACCGCCGTAAGGCCGATTAC -> CCGCCGTAAGGCCGATTACC
CCGCCGTAAGGCCGATTACC -> CGCCGTAAGGCCGATTACCG
CGCCGTAAGGCCGATTACCG -> GCCGTAAGGCCGATTACCGA
GCCGTAAGGCCGATTACCGA -> CCGTAAGGCCGATTACCGAT
CCGTAAGGCCGATTACCGAT -> CGTAAGGCCGATTACCGATC
CGTAAGGCCGATTACCGATC -> GTAAGGCCGATTACCGATCG
GTAAGGCCGATTACCGATCG -> TAAGGCCGATTACCGATCGT
TAAGGCCGATTACCGATCGT -> AAGGCCGATTACCGATCGTC
AAGGCCGATTACCGATCGTC -> AGGCCGATTACCGATCGTCG
AGGCCGATTACCGATCGTCG -> GGCCGATTACCGATCGTCGT
GGCCGATTACCGATCGTCGT -> GCCGATTACCGATCGTCGTC
GCCGATTACCGATCGTCGTC -> CCGATTACCGATCGTCGTCC
CCGATTACCGATCGTCGTCC -> CGATTACCGATCGTCGTCCC
CGATTACCGATCGTCGTCCC -> GATTACCGATCGTCGTCCCA
GATTACCGATCGTCGTCCCA -> ATTACCGATCGTCGTCCCAT
ATTACCGATCGTCGTCCCAT -> TTACCGATCGTCGTCCCATC
TTACCGATCGTCGTCCCATC -> TACCGATCGTCGTCCCATCC
TACCGATCGTCGTCCCATCC -> ACCGATCGTCGTCCCATCCT
ACCGATCGTCGTCCCATCCT -> CCGATCGTCGTCCCATCCTA
CCGATCGTCGTCCCATCCTA -> CGATCGTCGTCCCATCCTAC
CGATCGTCGTCCCATCCTAC -> GATCGTCGTCCCATCCTACG
GATCGTCGTCCCATCCTACG -> ATCGTCGTCCCATCCTACGC
ATCGTCGTCCCATCCTACGC -> TCGTCGTCCCATCCTACGCC
TCGTCGTCCCATCCTACGCC -> CGTCGTCCCATCCTACGCCT
CGTCGTCCCATCCTACGCCT -> GTCGTCCCATCCTACGCCTC
GTCGTCCCATCCTACGCCTC -> TCGTCCCATCCTACGCCTCT
TCGTCCCATCCTACGCCTCT -> CGTCCCATCCTACGCCTCTC
CGTCCCATCCTACGCCTCTC -> GTCCCATCCTACGCCTCTCT
GTCCCATCCTACGCCTCTCT -> TCCCATCCTACGCCTCTCTT
TCCCATCCTACGCCTCTCTT -> CCCATCCTACGCCTCTCTTC
CCCATCCTACGCCTCTCTTC -> CCATCCTACGCCTCTCTTCT
CCATCCTACGCCTCTCTTCT -> CATCCTACGCCTCTCTTCTG
CATCCTACGCCTCTCTTCTG -> ATCCTACGCCTCTCTTCTGA
ATCCTACGCCTCTCTTCTGA -> TCCTACGCCTCTCTTCTGAG
TCCTACGCCTCTCTTCTGAG -> CCTACGCCTCTCTTCTGAGA
CCTACGCCTCTCTTCTGAGA -> CTACGCCTCTCTTCTGAGAA
CTACGCCTCTCTTCTGAGAA -> TACGCCTCTCTTCTGAGAAA
TACGCCTCTCTTCTGAGAAA -> ACGCCTCTCTTCTGAGAAAC
ACGCCTCTCTTCTGAGAAAC -> CGCCTCTCTTCTGAGAAACA
CGCCTCTCTTCTGAGAAACA -> GCCTCTCTTCTGAGAAACAG
GCCTCTCTTCTGAGAAACAG -> CCTCTCTTCTGAGAAACAGA
CCTCTCTTCTGAGAAACAGA -> CTCTCTTCTGAGAAACAGAA
CTCTCTTCTGAGAAACAGAA -> TCTCTTCTGAGAAACAGAAT
TCTCTTCTGAGAAACAGAAT -> CTCTTCTGAGAAACAGAATT
CTCTTCTGAGAAACAGAATT -> TCTTCTGAGAAACAGAATTA
TCTTCTGAGAAACAGAATTA -> CTTCTGAGAAACAGAATTAT
CTTCTGAGAAACAGAATTAT -> TTCTGAGAAACAGAATTATA
TTCTGAGAAACAGAATTATA -> TCTGAGAAACAGAATTATAT
TCTGAGAAACAGAATTATAT -> CTGAGAAACAGAATTATATT
CTGAGAAACAGAATTATATT -> TGAGAAACAGAATTATATTC
TGAGAAACAGAATTATATTC -> GAGAAACAGAATTATATTCA
GAGAAACAGAATTATATTCA -> AGAAACAGAATTATATTCAC
AGAAACAGAATTATATTCAC -> GAAACAGAATTATATTCACA
GAAACAGAATTATATTCACA -> AAACAGAATTATATTCACAC
AAACAGAATTATATTCACAC -> AACAGAATTATATTCACACC
AACAGAATTATATTCACACC -> ACAGAATTATATTCACACCA
ACAGAATTATATTCACACCA -> CAGAATTATATTCACACCAA
CAGAATTATATTCACACCAA -> AGAATTATATTCACACCAAA
AGAATTATATTCACACCAAA -> GAATTATATTCACACCAAAT
GAATTATATTCACACCAAAT -> AATTATATTCACACCAAATA
AATTATATTCACACCAAATA -> ATTATATTCACACCAAATAA
ATTATATTCACACCAAATAA -> TTATATTCACACCAAATAAT
TTATATTCACACCAAATAAT -> TATATTCACACCAAATAATT
TATATTCACACCAAATAATT -> ATATTCACACCAAATAATTA
ATATTCACACCAAATAATTA -> TATTCACACCAAATAATTAA
TATTCACACCAAATAATTAA -> ATTCACACCAAATAATTAAC
ATTCACACCAAATAATTAAC -> TTCACACCAAATAATTAACC
TTCACACCAAATAATTAACC -> TCACACCAAATAATTAACCG
TCACACCAAATAATTAACCG -> CACACCAAATAATTAACCGA
CACACCAAATAATTAACCGA -> ACACCAAATAATTAACCGAT
ACACCAAATAATTAACCGAT -> CACCAAATAATTAACCGATT
CACCAAATAATTAACCGATT -> ACCAAATAATTAACCGATTA
ACCAAATAATTAACCGATTA -> CCAAATAATTAACCGATTAT
CCAAATAATTAACCGATTAT -> CAAATAATTAACCGATTATT
CAAATAATTAACCGATTATT -> AAATAATTAACCGATTATTA
AAATAATTAACCGATTATTA -> AATAATTAACCGATTATTAG
AATAATTAACCGATTATTAG -> ATAATTAACCGATTATTAGG
ATAATTAACCGATTATTAGG -> TAATTAACCGATTATTAGGC
TAATTAACCGATTATTAGGC -> AATTAACCGATTATTAGGCT
AATTAACCGATTATTAGGCT -> ATTAACCGATTATTAGGCTT
ATTAACCGATTATTAGGCTT -> TTAACCGATTATTAGGCTTA
TTAACCGATTATTAGGCTTA -> TAACCGATTATTAGGCTTAG
TAACCGATTATTAGGCTTAG -> AACCGATTATTAGGCTTAGG
AACCGATTATTAGGCTTAGG -> ACCGATTATTAGGCTTAGGG
ACCGATTATTAGGCTTAGGG -> CCGATTATTAGGCTTAGGGT
CCGATTATTAGGCTTAGGGT -> CGATTATTAGGCTTAGGGTT
CGATTATTAGGCTTAGGGTT -> GATTATTAGGCTTAGGGTTA
GATTATTAGGCTTAGGGTTA -> ATTATTAGGCTTAGGGTTAC
ATTATTAGGCTTAGGGTTAC -> TTATTAGGCTTAGGGTTACA
TTATTAGGCTTAGGGTTACA -> TATTAGGCTTAGGGTTACAT
TATTAGGCTTAGGGTTACAT -> ATTAGGCTTAGGGTTACATG
ATTAGGCTTAGGGTTACATG -> TTAGGCTTAGGGTTACATGC
TTAGGCTTAGGGTTACATGC -> TAGGCTTAGGGTTACATGCG
TAGGCTTAGGGTTACATGCG -> AGGCTTAGGGTTACATGCGA
AGGCTTAGGGTTACATGCGA -> GGCTTAGGGTTACATGCGAA
GGCTTAGGGTTACATGCGAA -> GCTTAGGGTTACATGCGAAA
GCTTAGGGTTACATGCGAAA -> CTTAGGGTTACATGCGAAAT
CTTAGGGTTACATGCGAAAT -> TTAGGGTTACATGCGAAATC
TTAGGGTTACATGCGAAATC -> TAGGGTTACATGCGAAATCT
TAGGGTTACATGCGAAATCT -> AGGGTTACATGCGAAATCTG
AGGGTTACATGCGAAATCTG -> GGGTTACATGCGAAATCTGC
GGGTTACATGCGAAATCTGC -> GGTTACATGCGAAATCTGCC
GGTTACATGCGAAATCTGCC -> GTTACATGCGAAATCTGCCC
GTTACATGCGAAATCTGCCC -> TTACATGCGAAATCTGCCCC
TTACATGCGAAATCTGCCCC -> TACATGCGAAATCTGCCCCG
TACATGCGAAATCTGCCCCG -> ACATGCGAAATCTGCCCCGA
ACATGCGAAATCTGCCCCGA -> CATGCGAAATCTGCCCCGAG
CATGCGAAATCTGCCCCGAG -> ATGCGAAATCTGCCCCGAGA
ATGCGAAATCTGCCCCGAGA -> TGCGAAATCTGCCCCGAGAG
TGCGAAATCTGCCCCGAGAG -> GCGAAATCTGCCCCGAGAGA
GCGAAATCTGCCCCGAGAGA -> CGAAATCTGCCCCGAGAGAT
CGAAATCTGCCCCGAGAGAT -> GAAATCTGCCCCGAGAGATT
GAAATCTGCCCCGAGAGATT -> AAATCTGCCCCGAGAGATTC
AAATCTGCCCCGAGAGATTC -> AATCTGCCCCGAGAGATTCA
AATCTGCCCCGAGAGATTCA -> ATCTGCCCCGAGAGATTCAG
ATCTGCCCCGAGAGATTCAG -> TCTGCCCCGAGAGATTCAGT
TCTGCCCCGAGAGATTCAGT -> CTGCCCCGAGAGATTCAGTT
CTGCCCCGAGAGATTCAGTT -> TGCCCCGAGAGATTCAGTTC
TGCCCCGAGAGATTCAGTTC -> GCCCCGAGAGATTCAGTTCG
GCCCCGAGAGATTCAGTTCG -> CCCCGAGAGATTCAGTTCGA
CCCCGAGAGATTCAGTTCGA -> CCCGAGAGATTCAGTTCGAT
CCCGAGAGATTCAGTTCGAT -> CCGAGAGATTCAGTTCGATT
CCGAGAGATTCAGTTCGATT -> CGAGAGATTCAGTTCGATTG
CGAGAGATTCAGTTCGATTG -> GAGAGATTCAGTTCGATTGA
GAGAGATTCAGTTCGATTGA -> AGAGATTCAGTTCGATTGAG
AGAGATTCAGTTCGATTGAG -> GAGATTCAGTTCGATTGAGG
GAGATTCAGTTCGATTGAGG -> AGATTCAGTTCGATTGAGGG
AGATTCAGTTCGATTGAGGG -> GATTCAGTTCGATTGAGGGT
GATTCAGTTCGATTGAGGGT -> ATTCAGTTCGATTGAGGGTT
ATTCAGTTCGATTGAGGGTT -> TTCAGTTCGATTGAGGGTTG