AAAAAGCACAT -> AAAAGCACATG
AAAAAGGGTGG -> AAAAGGGTGGA
AAAACGAAAGC -> AAACGAAAGCG
AAAACGTCAGG -> AAACGTCAGGT
AAAACTAATTA -> AAACTAATTAC
AAAAGCACATG -> AAAGCACATGT
AAAAGGGTGGA -> AAAGGGTGGAG
AAAAGGTCAGT -> AAAGGTCAGTG
AAAAGTTTACC -> AAAGTTTACCT
AAAATCTGGTT -> AAATCTGGTTT
AAAATGCCGTC -> AAATGCCGTCT
AAAATTCGGGT -> AAATTCGGGTC
AAACAAGCCCG -> AACAAGCCCGT
AAACGAAAGCG -> AACGAAAGCGT
AAACGTCAGGT -> AACGTCAGGTT
AAACGTCGCCT -> AACGTCGCCTG
AAACTAATTAC -> AACTAATTACC
AAACTAGGTGG -> AACTAGGTGGC
AAAGCACATGT -> AAGCACATGTC
AAAGCGCCATC -> AAGCGCCATCG
AAAGCGTGTGT -> AAGCGTGTGTC
AAAGGGATATA -> AAGGGATATAC
AAAGGGTGGAG -> AAGGGTGGAGA
AAAGGTCAGTG -> AAGGTCAGTGG
AAAGGTTATGC -> AAGGTTATGCC
AAAGTTTACCT -> AAGTTTACCTC
AAATCTGGTTT -> AATCTGGTTTG
AAATGATCGCA -> AATGATCGCAA
AAATGCCGTCT -> AATGCCGTCTT
AAATGGCAGCG -> AATGGCAGCGT
AAATGTCTACA -> AATGTCTACAC
AAATTCGGGTC -> AATTCGGGTCG
AAATTGCAGTT -> AATTGCAGTTT
AACAAGCCCGT -> ACAAGCCCGTG
AACAATACAAA -> ACAATACAAAA
AACAGCATAAA -> ACAGCATAAAA
AACAGTTCCCG -> ACAGTTCCCGT
AACCACAGCCT -> ACCACAGCCTG
AACCATACAGA -> ACCATACAGAG
AACCATGAATA -> ACCATGAATAC
AACCGGCTAAC -> ACCGGCTAACC
AACCTCGTCGG -> ACCTCGTCGGT
AACCTCTAACA -> ACCTCTAACAG
AACGAAAGCGT -> ACGAAAGCGTG
AACGAGATTAA -> ACGAGATTAAG
AACGCCTCCTA -> ACGCCTCCTAA
AACGGACAACT -> ACGGACAACTG
AACGTCAGGTT -> ACGTCAGGTTA
AACGTCGCCTG -> ACGTCGCCTGC
AACTAATTACC -> ACTAATTACCT
AACTACAGACA -> ACTACAGACAC
AACTAGGTGGC -> ACTAGGTGGCA
AACTCCTCAGT -> ACTCCTCAGTT
AACTGGACGAA -> ACTGGACGAAG
AACTGGCACTA -> ACTGGCACTAA
AACTTGTCGCA -> ACTTGTCGCAG
AACTTTATCGT -> ACTTTATCGTC
AAGACCGCTGG -> AGACCGCTGGC
AAGACGAGTCC -> AGACGAGTCCT
AAGACGTTTCC -> AGACGTTTCCG
AAGACTCCGTC -> AGACTCCGTCC
AAGAGGAGGAA -> AGAGGAGGAAG
AAGAGGTAGTG -> AGAGGTAGTGT
AAGAGTTATCC -> AGAGTTATCCG
AAGATCTCTCT -> AGATCTCTCTT
AAGATTCGGAC -> AGATTCGGACT
AAGCACATGTC -> AGCACATGTCC
AAGCAGCAATA -> AGCAGCAATAA
AAGCCAATGTT -> AGCCAATGTTC
AAGCCCGTGCT -> AGCCCGTGCTG
AAGCCTAAGGG -> AGCCTAAGGGC
AAGCCTGACGT -> AGCCTGACGTT
AAGCGCCATCG -> AGCGCCATCGT
AAGCGTGTGTC -> AGCGTGTGTCG
AAGCTGGAAAG -> AGCTGGAAAGG
AAGGGATATAC -> AGGGATATACA
AAGGGCCCCAA -> AGGGCCCCAAA
AAGGGGAGAAG -> AGGGGAGAAGA
AAGGGTGGAGA -> AGGGTGGAGAA
AAGGTCAGTGG -> AGGTCAGTGGG
AAGGTTATGCC -> AGGTTATGCCT
AAGTAACTTTA -> AGTAACTTTAT
AAGTAGCTAAA -> AGTAGCTAAAC
AAGTCATCAAG -> AGTCATCAAGT
AAGTTTACCTC -> AGTTTACCTCC
AATAAATTGCA -> ATAAATTGCAG
AATACAAAAGG -> ATACAAAAGGT
AATACACGACA -> ATACACGACAG
AATACCCGTCT -> ATACCCGTCTT
AATACGTGCCG -> ATACGTGCCGT
AATCATGTCAG -> ATCATGTCAGT
AATCGTGGGGA -> ATCGTGGGGAA
AATCTCTGGCC -> ATCTCTGGCCT
AATCTGGTTTG -> ATCTGGTTTGT
AATCTTTCCGA -> ATCTTTCCGAA
AATGACGGAAG -> ATGACGGAAGT
AATGAGGCGTA -> ATGAGGCGTAT
AATGATCGCAA -> ATGATCGCAAC
AATGCCGTCTT -> ATGCCGTCTTT
AATGCTAGTTT -> ATGCTAGTTTT
AATGCTCATGA -> ATGCTCATGAA
AATGGCAGCGT -> ATGGCAGCGTG
AATGTCTACAC -> ATGTCTACACC
AATGTGATCAT -> ATGTGATCATC
AATGTTACAGG -> ATGTTACAGGT
AATGTTCACTC -> ATGTTCACTCG
AATTACCTTTC -> ATTACCTTTCC
AATTAGCGGGC -> ATTAGCGGGCC
AATTCGGGTCG -> ATTCGGGTCGA
AATTGCAGTTT -> ATTGCAGTTTA
AATTGTCCGTA -> ATTGTCCGTAT
ACAAAAGGTCA -> CAAAAGGTCAG
ACAAACGTCGC -> CAAACGTCGCC
ACAACTGGACG -> CAACTGGACGA
ACAAGCCCGTG -> CAAGCCCGTGC
ACAATACAAAA -> CAATACAAAAG
ACACCGAGCGC -> CACCGAGCGCC
ACACCTTAAGG -> CACCTTAAGGG
ACACGACAGTA -> CACGACAGTAA
ACACTGACGTG -> CACTGACGTGA
ACAGACACCTT -> CAGACACCTTA
ACAGAGGAGAG -> CAGAGGAGAGT
ACAGCATAAAA -> CAGCATAAAAG
ACAGCCTGTAG -> CAGCCTGTAGT
ACAGGAGAGCT -> CAGGAGAGCTT
ACAGGTAGAGA -> CAGGTAGAGAG
ACAGGTATCTT -> CAGGTATCTTG
ACAGGTCCAAC -> CAGGTCCAACC
ACAGTAACCAC -> CAGTAACCACA
ACAGTTAGCGC -> CAGTTAGCGCA
ACAGTTCCCGT -> CAGTTCCCGTA
ACATAACGGAC -> CATAACGGACA
ACATAATGAGG -> CATAATGAGGC
ACATCACGCCT -> CATCACGCCTG
ACATCGGGCGG -> CATCGGGCGGA
ACATGGGAGTT -> CATGGGAGTTG
ACATGGGCTGC -> CATGGGCTGCC
ACATGTCCTTT -> CATGTCCTTTG
ACATTACTTCA -> CATTACTTCAA
ACCAATGACGG -> CCAATGACGGA
ACCACAGCCTG -> CCACAGCCTGT
ACCAGACATAA -> CCAGACATAAT
ACCATACAGAG -> CCATACAGAGG
ACCATGAATAC -> CCATGAATACC
ACCCATCTATT -> CCCATCTATTG
ACCCCCCCGCT -> CCCCCCCGCTT
ACCCGTCTTGT -> CCCGTCTTGTA
ACCCTGCGTAC -> CCCTGCGTACT
ACCGAGCGCCG -> CCGAGCGCCGA
ACCGCTACCGG -> CCGCTACCGGA
ACCGCTGGCAG -> CCGCTGGCAGC
ACCGGAGGCCC -> CCGGAGGCCCA
ACCGGCTAACC -> CCGGCTAACCT
ACCGTACGGAT -> CCGTACGGATA
ACCGTGATTTA -> CCGTGATTTAT
ACCTAAATGTC -> CCTAAATGTCT
ACCTAATCTTT -> CCTAATCTTTC
ACCTAGCAACT -> CCTAGCAACTG
ACCTAGCCGTG -> CCTAGCCGTGG
ACCTCAGGGAG -> CCTCAGGGAGA
ACCTCCTTGTC -> CCTCCTTGTCG
ACCTCGTCGGT -> CCTCGTCGGTT
ACCTCTAACAG -> CCTCTAACAGC
ACCTTAAGGGG -> CCTTAAGGGGA
ACCTTCACTCC -> CCTTCACTCCG
ACCTTTCCTTT -> CCTTTCCTTTG
ACCTTTTGCAC -> CCTTTTGCACC
ACGAAAGCGTG -> CGAAAGCGTGT
ACGAAGACGTT -> CGAAGACGTTT
ACGACACTGAC -> CGACACTGACG
ACGACAGTAAC -> CGACAGTAACC
ACGAGATTAAG -> CGAGATTAAGA
ACGAGTCCTCG -> CGAGTCCTCGA
ACGATATCGGA -> CGATATCGGAA
ACGATTCTACC -> CGATTCTACCC
ACGCACTGCGT -> CGCACTGCGTG
ACGCATGTGCC -> CGCATGTGCCA
ACGCCTCCTAA -> CGCCTCCTAAT
ACGCCTGCCTA -> CGCCTGCCTAC
ACGGAAGTAAC -> CGGAAGTAACT
ACGGAAGTCAT -> CGGAAGTCATC
ACGGACAACTG -> CGGACAACTGG
ACGGATATATC -> CGGATATATCA
ACGGGCCAGAC -> CGGGCCAGACA
ACGGTGATAGG -> CGGTGATAGGC
ACGGTTCTACC -> CGGTTCTACCT
ACGTCAGGTTA -> CGTCAGGTTAA
ACGTCCCCCTC -> CGTCCCCCTCC
ACGTCGCCTGC -> CGTCGCCTGCC
ACGTCTTTGCT -> CGTCTTTGCTC
ACGTGAGGTAA -> CGTGAGGTAAT
ACGTGCCGTTC -> CGTGCCGTTCG
ACGTTATCTGT -> CGTTATCTGTT
ACGTTCGTTAC -> CGTTCGTTACT
ACGTTTCCGCA -> CGTTTCCGCAG
ACTAAAACGAA -> CTAAAACGAAA
ACTAAGACCGC -> CTAAGACCGCT
ACTAATTACCT -> CTAATTACCTT
ACTACAGACAC -> CTACAGACACC
ACTAGGGATCA -> CTAGGGATCAG
ACTAGGTGGCA -> CTAGGTGGCAT
ACTCAGAGCGC -> CTCAGAGCGCC
ACTCAGGAGAA -> CTCAGGAGAAC
ACTCATCAATT -> CTCATCAATTG
ACTCATCGATT -> CTCATCGATTC
ACTCCGGCTCG -> CTCCGGCTCGT
ACTCCGTCCTC -> CTCCGTCCTCG
ACTCCTCAGTT -> CTCCTCAGTTT
ACTCGATAGTC -> CTCGATAGTCA,CTCGATAGTCG
ACTGACGTGAG -> CTGACGTGAGG
ACTGAGCGACC -> CTGAGCGACCA
ACTGATCCCTA -> CTGATCCCTAC
ACTGCGTGGAC -> CTGCGTGGACT
ACTGCTACCTT -> CTGCTACCTTT
ACTGGACGAAG -> CTGGACGAAGA
ACTGGATAATC -> CTGGATAATCT
ACTGGCACTAA -> CTGGCACTAAG
ACTGGGTGTGC -> CTGGGTGTGCT
ACTGTTAAGAC -> CTGTTAAGACG
ACTTACCCATC -> CTTACCCATCT
ACTTCAAAACT -> CTTCAAAACTA
ACTTGTCGCAG -> CTTGTCGCAGA
ACTTTATCGTC -> CTTTATCGTCG
ACTTTGAGGTG -> CTTTGAGGTGC
AGAAAATTCGG -> GAAAATTCGGG
AGAACAATACA -> GAACAATACAA
AGAACGCCTCC -> GAACGCCTCCT
AGAAGAGGAGG -> GAAGAGGAGGA
AGACAAACGTC -> GACAAACGTCG
AGACACCTTAA -> GACACCTTAAG
AGACATAATGA -> GACATAATGAG
AGACCGCTGGC -> GACCGCTGGCA
AGACCTCAGGG -> GACCTCAGGGA
AGACGAGTCCT -> GACGAGTCCTC
AGACGTTTCCG -> GACGTTTCCGC
AGACTCCGTCC -> GACTCCGTCCT
AGACTCGATAG -> GACTCGATAGT
AGAGACCTCAG -> GAGACCTCAGG
AGAGAGCCTGC -> GAGAGCCTGCC
AGAGCCTGCCT -> GAGCCTGCCTG
AGAGCGCCGAT -> GAGCGCCGATG
AGAGCTTTTAG -> GAGCTTTTAGC
AGAGGAGAGTC -> GAGGAGAGTCA
AGAGGAGGAAG -> GAGGAGGAAGC
AGAGGCCGGAC -> GAGGCCGGACC
AGAGGGTGAGT -> GAGGGTGAGTT
AGAGGTAGTGT -> GAGGTAGTGTG
AGAGTCATCTG -> GAGTCATCTGC
AGAGTTATCCG -> GAGTTATCCGA
AGATACCAATG -> GATACCAATGA
AGATCATTGGT -> GATCATTGGTC
AGATCCCTAGG -> GATCCCTAGGC
AGATCTCTCTT -> GATCTCTCTTA
AGATGTCCTGC -> GATGTCCTGCA
AGATTAAGATT -> GATTAAGATTC
AGATTCGGACT -> GATTCGGACTT
AGATTGGTCCC -> GATTGGTCCCG
AGCAACTGGCA -> GCAACTGGCAC
AGCAATAAATT -> GCAATAAATTG
AGCACATGGGC -> GCACATGGGCT
AGCACATGTCC -> GCACATGTCCT
AGCACGGTTCT -> GCACGGTTCTA
AGCAGCAATAA -> GCAGCAATAAA
AGCAGGCTCTT -> GCAGGCTCTTG
AGCATAAAAGT -> GCATAAAAGTT
AGCCAATGTTC -> GCCAATGTTCA
AGCCAGAGACC -> GCCAGAGACCT
AGCCATCGCTG -> GCCATCGCTGC
AGCCCGTGCTG -> GCCCGTGCTGC
AGCCCTATGTT -> GCCCTATGTTG
AGCCGTGGCCT -> GCCGTGGCCTT
AGCCTAAGGGC -> GCCTAAGGGCC
AGCCTGACGTT -> GCCTGACGTTC
AGCCTGCCTGT -> GCCTGCCTGTC
AGCCTGTAGTT -> GCCTGTAGTTG
AGCGACCAGAC -> GCGACCAGACA
AGCGACGGAAG -> GCGACGGAAGT
AGCGCAGCTGA -> GCGCAGCTGAG
AGCGCCATCGT -> GCGCCATCGTG
AGCGCCGAACC -> GCGCCGAACCA
AGCGCCGATGT -> GCGCCGATGTC
AGCGGGCCCTA -> GCGGGCCCTAC
AGCGTGACCGC -> GCGTGACCGCT
AGCGTGCGGCT -> GCGTGCGGCTT
AGCGTGTGTCG -> GCGTGTGTCGG
AGCTAAACTAG -> GCTAAACTAGG
AGCTGAGTTCA -> GCTGAGTTCAG
AGCTGGAAAGG -> GCTGGAAAGGG
AGCTTTCTTTG -> GCTTTCTTTGT
AGCTTTTAGCA -> GCTTTTAGCAG
AGGAAGCCAAT -> GGAAGCCAATG
AGGAGAACGCC -> GGAGAACGCCT
AGGAGAGCTTT -> GGAGAGCTTTT
AGGAGAGTCAT -> GGAGAGTCATC
AGGAGGAAGCC -> GGAGGAAGCCA
AGGCAATCATG -> GGCAATCATGT
AGGCATGCATT -> GGCATGCATTC
AGGCCCATCAG -> GGCCCATCAGG
AGGCCCGGGCC -> GGCCCGGGCCC
AGGCCGGACCT -> GGCCGGACCTT
AGGCCTCTGAG -> GGCCTCTGAGG
AGGCGGATATG -> GGCGGATATGG
AGGCGGGCTGT -> GGCGGGCTGTG
AGGCGTATCTA -> GGCGTATCTAC
AGGCTCTTGAG -> GGCTCTTGAGC
AGGGACAGGTA -> GGGACAGGTAT
AGGGAGAACAA -> GGGAGAACAAT
AGGGAGGTGTT -> GGGAGGTGTTT
AGGGATATACA -> GGGATATACAG
AGGGATCAGAG -> GGGATCAGAGG
AGGGCCCCAAA -> GGGCCCCAAAT
AGGGCGGTATG -> GGGCGGTATGG
AGGGGAGAAGA -> GGGGAGAAGAG
AGGGTAGACTC -> GGGTAGACTCG
AGGGTGAGTTA -> GGGTGAGTTAC
AGGGTGGAGAA -> GGGTGGAGAAA
AGGTAATTAGC -> GGTAATTAGCG
AGGTAGAGAGC -> GGTAGAGAGCC
AGGTAGTGTGC -> GGTAGTGTGCT
AGGTATCTTGC -> GGTATCTTGCA
AGGTATTTTAG -> GGTATTTTAGT
AGGTCAGTGGG -> GGTCAGTGGGT
AGGTCCAACCT -> GGTCCAACCTC
AGGTGCGCACT -> GGTGCGCACTA
AGGTGGCATCC -> GGTGGCATCCG
AGGTGTTTCCC -> GGTGTTTCCCA
AGGTTAAACAA -> GGTTAAACAAG
AGGTTATGCCT -> GGTTATGCCTG
AGGTTGAGTCT -> GGTTGAGTCTT
AGGTTTAGGCG -> GGTTTAGGCGG
AGTAACCACAG -> GTAACCACAGC
AGTAACTTTAT -> GTAACTTTATC
AGTAGCCATCG -> GTAGCCATCGC
AGTAGCTAAAC -> GTAGCTAAACT
AGTATATATGT -> GTATATATGTT
AGTATTTGAGA -> GTATTTGAGAT
AGTCATCAAGT -> GTCATCAAGTA
AGTCATCTGCC -> GTCATCTGCCT
AGTCATGGTGT -> GTCATGGTGTG
AGTCCACATCA -> GTCCACATCAC
AGTCCTCGAAA -> GTCCTCGAAAA
AGTCGATAGAT -> GTCGATAGATT
AGTCTTGTGTG -> GTCTTGTGTGC
AGTGGGTTTGA -> GTGGGTTTGAA
AGTGTGCTTCT -> GTGTGCTTCTA
AGTTACAGGTA -> GTTACAGGTAG
AGTTAGCGCAG -> GTTAGCGCAGC
AGTTAGGTATT -> GTTAGGTATTT
AGTTATCCGAA -> GTTATCCGAAC
AGTTCAGGCCC -> GTTCAGGCCCG
AGTTCCCGTAG -> GTTCCCGTAGG
AGTTCGGGTGA -> GTTCGGGTGAT
AGTTGGGACGA -> GTTGGGACGAT
AGTTGTAATAC -> GTTGTAATACG
AGTTTAACCGG -> GTTTAACCGGC
AGTTTACCTCC -> GTTTACCTCCT
AGTTTAGTATT -> GTTTAGTATTT
AGTTTATACTG -> GTTTATACTGG
AGTTTTTACTC -> GTTTTTACTCA
ATAAAACGTCA -> TAAAACGTCAG
ATAAAAGTTTA -> TAAAAGTTTAC
ATAAATTGCAG -> TAAATTGCAGT
ATAACGGACAA -> TAACGGACAAC
ATAATCTCTGG -> TAATCTCTGGC
ATAATGAGGCG -> TAATGAGGCGT
ATACAAAAGGT -> TACAAAAGGTC
ATACACGACAG -> TACACGACAGT
ATACAGAGGAG -> TACAGAGGAGA
ATACAGTTAGC -> TACAGTTAGCG
ATACCAATGAC -> TACCAATGACG
ATACCCGTCTT -> TACCCGTCTTG
ATACGTGCCGT -> TACGTGCCGTT
ATACTGGATAA -> TACTGGATAAT
ATAGATTGGTC -> TAGATTGGTCC
ATAGCCCTATG -> TAGCCCTATGT
ATAGGCATGCA -> TAGGCATGCAT
ATAGTCATGGT -> TAGTCATGGTG
ATAGTCGATAG -> TAGTCGATAGA
ATATACAGTTA -> TATACAGTTAG
ATATATCAATG -> TATATCAATGC
ATATATGTTAC -> TATATGTTACT
ATATCAAGCTG -> TATCAAGCTGG
ATATCAATGCT -> TATCAATGCTA
ATATCGGAACT -> TATCGGAACTA
ATATGGACATA -> TATGGACATAA
ATATGTCGCGT -> TATGTCGCGTC
ATATGTTACTG -> TATGTTACTGG
ATCAACGAGAT -> TCAACGAGATT
ATCAAGCTGGA -> TCAAGCTGGAA
ATCAAGTAGCT -> TCAAGTAGCTA
ATCAATGCTAG -> TCAATGCTAGT
ATCAATTGTCC -> TCAATTGTCCG
ATCACGCCTGC -> TCACGCCTGCC
ATCAGAGGCCG -> TCAGAGGCCGG
ATCAGGTTTAG -> TCAGGTTTAGG
ATCATCAACGA -> TCATCAACGAG
ATCATGTCAGT -> TCATGTCAGTA
ATCATTGGTCT -> TCATTGGTCTC
ATCCCTACTGT -> TCCCTACTGTT
ATCCCTAGGCC -> TCCCTAGGCCT
ATCCGAACTCC -> TCCGAACTCCT
ATCCGTCGAAA -> TCCGTCGAAAG
ATCGACTAAAA -> TCGACTAAAAC
ATCGATTCCTC -> TCGATTCCTCG
ATCGCAACAGT -> TCGCAACAGTT
ATCGCTGCCCT -> TCGCTGCCCTG
ATCGGAACTAC -> TCGGAACTACA
ATCGGGCGGAT -> TCGGGCGGATA
ATCGTCGTACC -> TCGTCGTACCG
ATCGTGCACGT -> TCGTGCACGTC
ATCGTGGGGAA -> TCGTGGGGAAG
ATCTACCCCCC -> TCTACCCCCCC
ATCTATTGCAC -> TCTATTGCACG
ATCTCTCTTAT -> TCTCTCTTATG
ATCTCTGGCCT -> TCTCTGGCCTC
ATCTGCCTGTG -> TCTGCCTGTGT
ATCTGGTTTGT -> TCTGGTTTGTA
ATCTGTTGACA -> TCTGTTGACAG
ATCTTGCACGT -> TCTTGCACGTT
ATCTTTCCGAA -> TCTTTCCGAAG
ATGAAAGGTTA -> TGAAAGGTTAT
ATGAATACCCG -> TGAATACCCGT
ATGACGGAAGT -> TGACGGAAGTA
ATGACTCATCG -> TGACTCATCGA
ATGAGCACATG -> TGAGCACATGG
ATGAGGCGTAT -> TGAGGCGTATC
ATGATCGCAAC -> TGATCGCAACA
ATGCATTCTTA -> TGCATTCTTAT
ATGCCGTCTTT -> TGCCGTCTTTA
ATGCCTGCCCA -> TGCCTGCCCAG
ATGCGAGATCA -> TGCGAGATCAT
ATGCTAGTAGC -> TGCTAGTAGCC
ATGCTAGTTTT -> TGCTAGTTTTT
ATGCTCATGAA -> TGCTCATGAAA
ATGGACATAAC -> TGGACATAACG
ATGGCAGCGTG -> TGGCAGCGTGC
ATGGCGGTTAC -> TGGCGGTTACA
ATGGGAGTTGG -> TGGGAGTTGGG
ATGGGCTGCCA -> TGGGCTGCCAT
ATGGTGTCTTG -> TGGTGTCTTGC
ATGGTGTGATG -> TGGTGTGATGG
ATGGTTACTCA -> TGGTTACTCAG
ATGTCAGGGCG -> TGTCAGGGCGG
ATGTCAGTATA -> TGTCAGTATAT
ATGTCCTGCAC -> TGTCCTGCACC
ATGTCCTTTGC -> TGTCCTTTGCC
ATGTCGCGTCA -> TGTCGCGTCAA
ATGTCTACACC -> TGTCTACACCG
ATGTGATCATC -> TGTGATCATCA
ATGTGCCAGGC -> TGTGCCAGGCA
ATGTTACAGGT -> TGTTACAGGTC
ATGTTACTGGG -> TGTTACTGGGT
ATGTTCACTCG -> TGTTCACTCGA
ATGTTGTTAAC -> TGTTGTTAACT
ATTAAGATTCG -> TTAAGATTCGG
ATTACCTTTCC -> TTACCTTTCCT
ATTACTTCAAA -> TTACTTCAAAA
ATTAGCGGGCC -> TTAGCGGGCCC
ATTCCTCGGCA -> TTCCTCGGCAC
ATTCGGACTTT -> TTCGGACTTTG
ATTCGGGTCGA -> TTCGGGTCGAT
ATTCTACCCTG -> TTCTACCCTGC
ATTCTTATGCT -> TTCTTATGCTA
ATTGCACGCAT -> TTGCACGCATG
ATTGCAGTTTA -> TTGCAGTTTAG
ATTGGTCCCGT -> TTGGTCCCGTG
ATTGGTCTCAG -> TTGGTCTCAGC
ATTGTCCGTAT -> TTGTCCGTATG
ATTTATGGTGT -> TTTATGGTGTC
ATTTGAATGTT -> TTTGAATGTTA
ATTTGAGATCC -> TTTGAGATCCC
ATTTTAGTTTA -> TTTTAGTTTAA
CAAAAAGGGTG -> AAAAAGGGTGG
CAAAACTAATT -> AAAACTAATTA
CAAAAGGTCAG -> AAAAGGTCAGT
CAAACGTCGCC -> AAACGTCGCCT
CAAATGATCGC -> AAATGATCGCA
CAAATGGCAGC -> AAATGGCAGCG
CAACAGTTCCC -> AACAGTTCCCG
CAACCATGAAT -> AACCATGAATA
CAACCTCGTCG -> AACCTCGTCGG
CAACGAGATTA -> AACGAGATTAA
CAACTGGACGA -> AACTGGACGAA
CAACTGGCACT -> AACTGGCACTA
CAAGATCTCTC -> AAGATCTCTCT
CAAGCCCGTGC -> AAGCCCGTGCT
CAAGCTGGAAA -> AAGCTGGAAAG
CAAGTAGCTAA -> AAGTAGCTAAA
CAATAAATTGC -> AATAAATTGCA
CAATACAAAAG -> AATACAAAAGG
CAATACACGAC -> AATACACGACA
CAATCATGTCA -> AATCATGTCAG
CAATGACGGAA -> AATGACGGAAG
CAATGCTAGTT -> AATGCTAGTTT
CAATGTGATCA -> AATGTGATCAT
CAATGTTCACT -> AATGTTCACTC
CAATTGTCCGT -> AATTGTCCGTA
CACAGCCTGTA -> ACAGCCTGTAG
CACATCACGCC -> ACATCACGCCT
CACATCGGGCG -> ACATCGGGCGG
CACATGGGCTG -> ACATGGGCTGC
CACATGTCCTT -> ACATGTCCTTT
CACATTACTTC -> ACATTACTTCA
CACCGAGCGCC -> ACCGAGCGCCG
CACCGTACGGA -> ACCGTACGGAT
CACCTAAATGT -> ACCTAAATGTC
CACCTTAAGGG -> ACCTTAAGGGG
CACGACAGTAA -> ACGACAGTAAC
CACGCACTGCG -> ACGCACTGCGT
CACGCATGTGC -> ACGCATGTGCC
CACGCCTGCCT -> ACGCCTGCCTA
CACGGTGATAG -> ACGGTGATAGG
CACGGTTCTAC -> ACGGTTCTACC
CACGTCCCCCT -> ACGTCCCCCTC
CACGTCTTTGC -> ACGTCTTTGCT
CACGTTATCTG -> ACGTTATCTGT
CACTAAGACCG -> ACTAAGACCGC
CACTAGGGATC -> ACTAGGGATCA
CACTCCGGCTC -> ACTCCGGCTCG
CACTCGATAGT -> ACTCGATAGTC
CACTGACGTGA -> ACTGACGTGAG
CACTGCGTGGA -> ACTGCGTGGAC
CACTGCTACCT -> ACTGCTACCTT
CAGACAAACGT -> AGACAAACGTC
CAGACACCTTA -> AGACACCTTAA
CAGACATAATG -> AGACATAATGA
CAGAGACCTCA -> AGAGACCTCAG
CAGAGCGCCGA -> AGAGCGCCGAT
CAGAGGAGAGT -> AGAGGAGAGTC
CAGAGGCCGGA -> AGAGGCCGGAC
CAGAGGGTGAG -> AGAGGGTGAGT
CAGATACCAAT -> AGATACCAATG
CAGCAATAAAT -> AGCAATAAATT
CAGCACGGTTC -> AGCACGGTTCT
CAGCATAAAAG -> AGCATAAAAGT
CAGCCAGAGAC -> AGCCAGAGACC
CAGCCTGTAGT -> AGCCTGTAGTT
CAGCGTGACCG -> AGCGTGACCGC
CAGCGTGCGGC -> AGCGTGCGGCT
CAGCTGAGTTC -> AGCTGAGTTCA
CAGGAGAACGC -> AGGAGAACGCC
CAGGAGAGCTT -> AGGAGAGCTTT
CAGGCAATCAT -> AGGCAATCATG
CAGGCCCGGGC -> AGGCCCGGGCC
CAGGCGGGCTG -> AGGCGGGCTGT
CAGGCTCTTGA -> AGGCTCTTGAG
CAGGGAGAACA -> AGGGAGAACAA
CAGGGCGGTAT -> AGGGCGGTATG
CAGGTAGAGAG -> AGGTAGAGAGC
CAGGTATCTTG -> AGGTATCTTGC
CAGGTCCAACC -> AGGTCCAACCT
CAGGTTAAACA -> AGGTTAAACAA
CAGGTTTAGGC -> AGGTTTAGGCG
CAGTAACCACA -> AGTAACCACAG
CAGTATATATG -> AGTATATATGT
CAGTCCACATC -> AGTCCACATCA
CAGTGGGTTTG -> AGTGGGTTTGA
CAGTTAGCGCA -> AGTTAGCGCAG
CAGTTAGGTAT -> AGTTAGGTATT
CAGTTCCCGTA -> AGTTCCCGTAG
CAGTTCGGGTG -> AGTTCGGGTGA
CAGTTTAGTAT -> AGTTTAGTATT
CAGTTTATACT -> AGTTTATACTG
CATAAAAGTTT -> ATAAAAGTTTA
CATAACGGACA -> ATAACGGACAA
CATAATGAGGC -> ATAATGAGGCG
CATACAGAGGA -> ATACAGAGGAG
CATATGTCGCG -> ATATGTCGCGT
CATCAACGAGA -> ATCAACGAGAT
CATCAAGTAGC -> ATCAAGTAGCT
CATCAATTGTC -> ATCAATTGTCC
CATCACGCCTG -> ATCACGCCTGC
CATCAGGTTTA -> ATCAGGTTTAG
CATCCGTCGAA -> ATCCGTCGAAA
CATCGATTCCT -> ATCGATTCCTC
CATCGCTGCCC -> ATCGCTGCCCT
CATCGGGCGGA -> ATCGGGCGGAT
CATCGTGCACG -> ATCGTGCACGT
CATCTATTGCA -> ATCTATTGCAC
CATCTGCCTGT -> ATCTGCCTGTG
CATGAAAGGTT -> ATGAAAGGTTA
CATGAATACCC -> ATGAATACCCG
CATGCATTCTT -> ATGCATTCTTA
CATGGCGGTTA -> ATGGCGGTTAC
CATGGGAGTTG -> ATGGGAGTTGG
CATGGGCTGCC -> ATGGGCTGCCA
CATGGTGTGAT -> ATGGTGTGATG
CATGTCAGTAT -> ATGTCAGTATA
CATGTCCTTTG -> ATGTCCTTTGC
CATGTGCCAGG -> ATGTGCCAGGC
CATTACTTCAA -> ATTACTTCAAA
CATTCTTATGC -> ATTCTTATGCT
CATTGGTCTCA -> ATTGGTCTCAG
CCAAAAAGGGT -> CAAAAAGGGTG
CCAAATGATCG -> CAAATGATCGC
CCAACCATGAA -> CAACCATGAAT
CCAACCTCGTC -> CAACCTCGTCG
CCAATACACGA -> CAATACACGAC
CCAATGACGGA -> CAATGACGGAA
CCAATGTTCAC -> CAATGTTCACT
CCACAGCCTGT -> CACAGCCTGTA
CCACATCACGC -> CACATCACGCC
CCACATCGGGC -> CACATCGGGCG
CCACGCACTGC -> CACGCACTGCG
CCACGTCCCCC -> CACGTCCCCCT
CCAGACAAACG -> CAGACAAACGT
CCAGACATAAT -> CAGACATAATG
CCAGAGACCTC -> CAGAGACCTCA
CCAGGCAATCA -> CAGGCAATCAT
CCAGTCCACAT -> CAGTCCACATC
CCAGTTCGGGT -> CAGTTCGGGTG
CCATACAGAGG -> CATACAGAGGA
CCATATGTCGC -> CATATGTCGCG
CCATCAGGTTT -> CATCAGGTTTA
CCATCGCTGCC -> CATCGCTGCCC
CCATCGTGCAC -> CATCGTGCACG
CCATCTATTGC -> CATCTATTGCA
CCATGAATACC -> CATGAATACCC
CCCAAAAAGGG -> CCAAAAAGGGT
CCCAAATGATC -> CCAAATGATCG
CCCAATACACG -> CCAATACACGA
CCCACATCGGG -> CCACATCGGGC
CCCAGTCCACA -> CCAGTCCACAT
CCCAGTTCGGG -> CCAGTTCGGGT
CCCATCAGGTT -> CCATCAGGTTT
CCCATCTATTG -> CCATCTATTGC
CCCCAAATGAT -> CCCAAATGATC
CCCCAATACAC -> CCCAATACACG
CCCCCCCGCTT -> CCCCCCGCTTG
CCCCCCGCTTG -> CCCCCGCTTGA
CCCCCGCTTGA -> CCCCGCTTGAG
CCCCCGTATAT -> CCCCGTATATC
CCCCCTCCAAC -> CCCCTCCAACC
CCCCGCTTGAG -> CCCGCTTGAGG
CCCCGTATATC -> CCCGTATATCA
CCCCTCCAACC -> CCCTCCAACCA
CCCGCTTGAGG -> CCGCTTGAGGG
CCCGGGCCCAC -> CCGGGCCCACA
CCCGTAGGGTA -> CCGTAGGGTAG
CCCGTATATCA -> CCGTATATCAA
CCCGTCTTGTA -> CCGTCTTGTAA
CCCGTGAAGAG -> CCGTGAAGAGT
CCCGTGCTGCT -> CCGTGCTGCTT
CCCTACGATTC -> CCTACGATTCT
CCCTACTGTTA -> CCTACTGTTAA
CCCTAGGCCTC -> CCTAGGCCTCT
CCCTATGTTGT -> CCTATGTTGTT
CCCTCCAACCA -> CCTCCAACCAT
CCCTGCGTACT -> CCTGCGTACTC
CCCTGTTGCGC -> CCTGTTGCGCA
CCGAACCATAC -> CGAACCATACA
CCGAACTCCTC -> CGAACTCCTCA
CCGAAGAGGTA -> CGAAGAGGTAG
CCGACTTACCC -> CGACTTACCCA
CCGAGCGCCGA -> CGAGCGCCGAA
CCGATGTCAGG -> CGATGTCAGGG
CCGCAGCACGG -> CGCAGCACGGT
CCGCTACCGGA -> CGCTACCGGAG
CCGCTGGCAGC -> CGCTGGCAGCC
CCGCTTGAGGG -> CGCTTGAGGGA
CCGGACCTTCA -> CGGACCTTCAC
CCGGAGGCCCA -> CGGAGGCCCAT
CCGGAGGGAGG -> CGGAGGGAGGT
CCGGCTAACCT -> CGGCTAACCTC
CCGGCTCGTCG -> CGGCTCGTCGC
CCGGGCCCACA -> CGGGCCCACAT
CCGTACGGATA -> CGTACGGATAT
CCGTAGGGTAG -> CGTAGGGTAGA
CCGTATATCAA -> CGTATATCAAG
CCGTATGCGAG -> CGTATGCGAGA
CCGTCCTCGGT -> CGTCCTCGGTC
CCGTCGAAAGC -> CGTCGAAAGCG
CCGTCTTGTAA -> CGTCTTGTAAA
CCGTCTTTAGA -> CGTCTTTAGAT
CCGTGAAGAGT -> CGTGAAGAGTT
CCGTGATTTAT -> CGTGATTTATG
CCGTGCTGCTT -> CGTGCTGCTTC
CCGTGGCCTTC -> CGTGGCCTTCA
CCGTGGCTTCC -> CGTGGCTTCCG
CCGTTCGGGCT -> CGTTCGGGCTT
CCTAAATGTCT -> CTAAATGTCTA
CCTAAGGGCCC -> CTAAGGGCCCC
CCTAATCGTGG -> CTAATCGTGGG
CCTAATCTTTC -> CTAATCTTTCC
CCTACCTAATC -> CTACCTAATCT
CCTACGACACT -> CTACGACACTG
CCTACGATTCT -> CTACGATTCTA
CCTACTGTTAA -> CTACTGTTAAG
CCTAGCAACTG -> CTAGCAACTGG
CCTAGCCGTGG -> CTAGCCGTGGC
CCTAGGCCTCT -> CTAGGCCTCTG
CCTATGTTGTT -> CTATGTTGTTA
CCTCAGGGAGA -> CTCAGGGAGAA
CCTCAGTTTAT -> CTCAGTTTATA
CCTCCAACCAT -> CTCCAACCATG
CCTCCTAATCG -> CTCCTAATCGT
CCTCCTTGTCG -> CTCCTTGTCGT
CCTCGAAAAAG -> CTCGAAAAAGC
CCTCGGCACGG -> CTCGGCACGGT
CCTCGGTCAGT -> CTCGGTCAGTT
CCTCGTCGGTT -> CTCGTCGGTTT
CCTCTAACAGC -> CTCTAACAGCA
CCTCTAATGCT -> CTCTAATGCTC
CCTCTGAGGTT -> CTCTGAGGTTG
CCTGACGTTCG -> CTGACGTTCGT
CCTGCACCTAA -> CTGCACCTAAA
CCTGCCACGCA -> CTGCCACGCAC
CCTGCCCAGTT -> CTGCCCAGTTC
CCTGCCTACCT -> CTGCCTACCTA
CCTGCCTGTCA -> CTGCCTGTCAA
CCTGCGTACTC -> CTGCGTACTCA
CCTGTAGTTGT -> CTGTAGTTGTA
CCTGTCAAATG -> CTGTCAAATGG
CCTGTGTCCGT -> CTGTGTCCGTG
CCTGTTGCGCA -> CTGTTGCGCAC
CCTTAAGGGGA -> CTTAAGGGGAG
CCTTCACATTA -> CTTCACATTAC
CCTTCACTCCG -> CTTCACTCCGG
CCTTGTCGTTG -> CTTGTCGTTGA
CCTTTCCTTTG -> CTTTCCTTTGC
CCTTTGCCTAC -> CTTTGCCTACG
CCTTTGCTGCC -> CTTTGCTGCCC
CCTTTTGCACC -> CTTTTGCACCG
CGAAAAAGCAC -> GAAAAAGCACA
CGAAAGCGCCA -> GAAAGCGCCAT
CGAAAGCGTGT -> GAAAGCGTGTG
CGAACCATACA -> GAACCATACAG
CGAACTCCTCA -> GAACTCCTCAG
CGAAGACGTTT -> GAAGACGTTTC
CGAAGAGGTAG -> GAAGAGGTAGT
CGACACTGACG -> GACACTGACGT
CGACAGTAACC -> GACAGTAACCA
CGACCAGACAT -> GACCAGACATA
CGACGGAAGTC -> GACGGAAGTCA
CGACTAAAACG -> GACTAAAACGA
CGACTTACCCA -> GACTTACCCAT
CGAGATCATTG -> GAGATCATTGG
CGAGATTAAGA -> GAGATTAAGAT
CGAGCGCCGAA -> GAGCGCCGAAC
CGAGTCCTCGA -> GAGTCCTCGAA
CGATAAAACGT -> GATAAAACGTC
CGATAGATTGG -> GATAGATTGGT
CGATAGTCATG -> GATAGTCATGG
CGATAGTCGAT -> GATAGTCGATA
CGATATCGGAA -> GATATCGGAAC
CGATGACTCAT -> GATGACTCATC
CGATGTCAGGG -> GATGTCAGGGC
CGATTCCTCGG -> GATTCCTCGGC
CGATTCTACCC -> GATTCTACCCT
CGCAACAGTTC -> GCAACAGTTCC
CGCACTAGGGA -> GCACTAGGGAT
CGCACTGCGTG -> GCACTGCGTGG
CGCACTGCTAC -> GCACTGCTACC
CGCAGATACCA -> GCAGATACCAA
CGCAGCACGGT -> GCAGCACGGTT
CGCAGCTGAGT -> GCAGCTGAGTT
CGCATGTGCCA -> GCATGTGCCAG
CGCCATCGTGC -> GCCATCGTGCA
CGCCGAACCAT -> GCCGAACCATA
CGCCGACTTAC -> GCCGACTTACC
CGCCGATGTCA -> GCCGATGTCAG
CGCCTCCTAAT -> GCCTCCTAATC
CGCCTGCCACG -> GCCTGCCACGC
CGCCTGCCTAC -> GCCTGCCTACC
CGCGATGACTC -> GCGATGACTCA
CGCGCCGACTT -> GCGCCGACTTA
CGCGTCAATGT -> GCGTCAATGTG
CGCGTCAGGCG -> GCGTCAGGCGG
CGCTACCGGAG -> GCTACCGGAGG
CGCTCGCGCCG -> GCTCGCGCCGA
CGCTGCCCTGT -> GCTGCCCTGTT
CGCTGGCAGCC -> GCTGGCAGCCA
CGCTTGAGGGA -> GCTTGAGGGAC
CGGAACTACAG -> GGAACTACAGA
CGGAAGTAACT -> GGAAGTAACTT
CGGAAGTCATC -> GGAAGTCATCA
CGGACAACTGG -> GGACAACTGGA
CGGACCTTCAC -> GGACCTTCACT
CGGACTTTGAG -> GGACTTTGAGG
CGGAGGCCCAT -> GGAGGCCCATC
CGGAGGGAGGT -> GGAGGGAGGTG
CGGATAGCCCT -> GGATAGCCCTA
CGGATATATCA -> GGATATATCAA
CGGATATGGAC -> GGATATGGACA
CGGCACGGTGA -> GGCACGGTGAT
CGGCTAACCTC -> GGCTAACCTCT
CGGCTCGTCGC -> GGCTCGTCGCT
CGGCTTAAGAC -> GGCTTAAGACT
CGGGCCAGACA -> GGGCCAGACAA
CGGGCCCACAT -> GGGCCCACATC
CGGGCCCTACG -> GGGCCCTACGA
CGGGCGGATAG -> GGGCGGATAGC
CGGGCTGTGCG -> GGGCTGTGCGC
CGGGCTTACGG -> GGGCTTACGGG
CGGGTCGATAA -> GGGTCGATAAA
CGGGTGATCGA -> GGGTGATCGAC
CGGTATGGTTA -> GGTATGGTTAC
CGGTCAGTTAG -> GGTCAGTTAGG
CGGTCCCAGTC -> GGTCCCAGTCC
CGGTGATAGGC -> GGTGATAGGCA
CGGTTACATGG -> GGTTACATGGG
CGGTTCTACCT -> GGTTCTACCTA
CGGTTTTTGAA -> GGTTTTTGAAA
CGTACCGTGAT -> GTACCGTGATT
CGTACGGATAT -> GTACGGATATA
CGTACTCATCA -> GTACTCATCAA
CGTAGGGTAGA -> GTAGGGTAGAC
CGTATATCAAG -> GTATATCAAGC
CGTATCTACCC -> GTATCTACCCC
CGTATGCGAGA -> GTATGCGAGAT
CGTCAATGTGA -> GTCAATGTGAT
CGTCAGGCGGG -> GTCAGGCGGGC
CGTCAGGTTAA -> GTCAGGTTAAA
CGTCCCCCTCC -> GTCCCCCTCCA
CGTCCTCGGTC -> GTCCTCGGTCA
CGTCGAAAGCG -> GTCGAAAGCGC
CGTCGCCTGCC -> GTCGCCTGCCA
CGTCGCTCGCG -> GTCGCTCGCGC
CGTCGGTTTTT -> GTCGGTTTTTG
CGTCGTACCGT -> GTCGTACCGTG
CGTCTTGTAAA -> GTCTTGTAAAA
CGTCTTTAGAT -> GTCTTTAGATG
CGTCTTTGCTC -> GTCTTTGCTCG
CGTGAAGAGTT -> GTGAAGAGTTA
CGTGACCGCTA -> GTGACCGCTAC
CGTGAGGTAAT -> GTGAGGTAATT
CGTGATTTATG -> GTGATTTATGG
CGTGCACGTCT -> GTGCACGTCTT
CGTGCCGTTCG -> GTGCCGTTCGG
CGTGCGGCTTA -> GTGCGGCTTAA
CGTGCTGCTTC -> GTGCTGCTTCA
CGTGGACTGAG -> GTGGACTGAGC
CGTGGCCTTCA -> GTGGCCTTCAC
CGTGGCTTCCG -> GTGGCTTCCGG
CGTGGGGAAGC -> GTGGGGAAGCC
CGTGTGTCGGT -> GTGTGTCGGTC
CGTTACTGATC -> GTTACTGATCC
CGTTATCTGTT -> GTTATCTGTTG
CGTTCGGGCTT -> GTTCGGGCTTA
CGTTCGTTACT -> GTTCGTTACTG
CGTTGAGCTTT -> GTTGAGCTTTC
CGTTTCCGCAG -> GTTTCCGCAGC
CTAAAACGAAA -> TAAAACGAAAG
CTAAACTAGGT -> TAAACTAGGTG
CTAAATGTCTA -> TAAATGTCTAC
CTAACAGCATA -> TAACAGCATAA
CTAACCTCTAA -> TAACCTCTAAC
CTAAGACCGCT -> TAAGACCGCTG
CTAAGGGCCCC -> TAAGGGCCCCA
CTAATCGTGGG -> TAATCGTGGGG
CTAATCTTTCC -> TAATCTTTCCG
CTAATGCTCAT -> TAATGCTCATG
CTAATTACCTT -> TAATTACCTTT
CTACACCGAGC -> TACACCGAGCG
CTACAGACACC -> TACAGACACCT
CTACCCCCCCG -> TACCCCCCCGC
CTACCCTGCGT -> TACCCTGCGTA
CTACCGGAGGC -> TACCGGAGGCC
CTACCTAATCT -> TACCTAATCTT
CTACCTAGCAA -> TACCTAGCAAC
CTACCTAGCCG -> TACCTAGCCGT
CTACCTTTTGC -> TACCTTTTGCA
CTACGACACTG -> TACGACACTGA
CTACGATTCTA -> TACGATTCTAC
CTACTGTTAAG -> TACTGTTAAGA
CTAGCAACTGG -> TAGCAACTGGC
CTAGCCGTGGC -> TAGCCGTGGCC
CTAGGCCTCTG -> TAGGCCTCTGA
CTAGGGATCAG -> TAGGGATCAGA
CTAGGTGGCAT -> TAGGTGGCATC
CTAGTAGCCAT -> TAGTAGCCATC
CTAGTTTTTAC -> TAGTTTTTACT
CTATGTTGTTA -> TATGTTGTTAA
CTATTGCACGC -> TATTGCACGCA
CTCAGAGCGCC -> TCAGAGCGCCG
CTCAGAGGGTG -> TCAGAGGGTGA
CTCAGCGTGAC -> TCAGCGTGACC
CTCAGGAGAAC -> TCAGGAGAACG
CTCAGGGAGAA -> TCAGGGAGAAC
CTCAGTTTATA -> TCAGTTTATAC
CTCATCAATTG -> TCATCAATTGT
CTCATCGATTC -> TCATCGATTCC
CTCATGAAAGG -> TCATGAAAGGT
CTCCAACCATG -> TCCAACCATGA
CTCCGGCTCGT -> TCCGGCTCGTC
CTCCGTCCTCG -> TCCGTCCTCGG
CTCCTAATCGT -> TCCTAATCGTG
CTCCTCAGTTT -> TCCTCAGTTTA
CTCCTTGTCGT -> TCCTTGTCGTT
CTCGAAAAAGC -> TCGAAAAAGCA
CTCGATAGTCA -> TCGATAGTCAT
CTCGATAGTCG -> TCGATAGTCGA
CTCGCGCCGAC -> TCGCGCCGACT
CTCGCGTCAGG -> TCGCGTCAGGC
CTCGGCACGGT -> TCGGCACGGTG
CTCGGTCAGTT -> TCGGTCAGTTA
CTCGTCGCTCG -> TCGTCGCTCGC
CTCGTCGGTTT -> TCGTCGGTTTT
CTCTAACAGCA -> TCTAACAGCAT
CTCTAATGCTC -> TCTAATGCTCA
CTCTCTTATGA -> TCTCTTATGAG
CTCTGAGGTTG -> TCTGAGGTTGA
CTCTGGCCTCT -> TCTGGCCTCTA
CTCTTATGAGC -> TCTTATGAGCA
CTCTTGAGCGA -> TCTTGAGCGAC
CTGACGTGAGG -> TGACGTGAGGT
CTGACGTTCGT -> TGACGTTCGTT
CTGAGCGACCA -> TGAGCGACCAG
CTGAGGTTGAG -> TGAGGTTGAGT
CTGAGTTCAGG -> TGAGTTCAGGC
CTGATCCCTAC -> TGATCCCTACT
CTGCACCTAAA -> TGCACCTAAAT
CTGCCACGCAC -> TGCCACGCACT
CTGCCATATGT -> TGCCATATGTC
CTGCCCAGTTC -> TGCCCAGTTCG
CTGCCCCCGTA -> TGCCCCCGTAT
CTGCCCTGTTG -> TGCCCTGTTGC
CTGCCTACCTA -> TGCCTACCTAA
CTGCCTGTCAA -> TGCCTGTCAAA
CTGCCTGTGTC -> TGCCTGTGTCC
CTGCGTACTCA -> TGCGTACTCAT
CTGCGTGGACT -> TGCGTGGACTG
CTGCTACCTTT -> TGCTACCTTTT
CTGCTTCAAGA -> TGCTTCAAGAT
CTGGAAAGGGA -> TGGAAAGGGAT
CTGGACGAAGA -> TGGACGAAGAC
CTGGATAATCT -> TGGATAATCTC
CTGGCACTAAG -> TGGCACTAAGA
CTGGCAGCCAG -> TGGCAGCCAGA
CTGGCCTCTAA -> TGGCCTCTAAT
CTGGGTGTGCT -> TGGGTGTGCTC
CTGGTTTGTAA -> TGGTTTGTAAG
CTGTAGTTGTA -> TGTAGTTGTAA
CTGTCAAATGG -> TGTCAAATGGC
CTGTGCGCGAT -> TGTGCGCGATG
CTGTGTCCGTG -> TGTGTCCGTGG
CTGTTAAGACG -> TGTTAAGACGA
CTGTTGACAGG -> TGTTGACAGGA
CTGTTGCGCAC -> TGTTGCGCACT
CTTAAGACTCC -> TTAAGACTCCG
CTTAAGGGGAG -> TTAAGGGGAGA
CTTACCCATCT -> TTACCCATCTA
CTTACGGGCCA -> TTACGGGCCAG
CTTATGAGCAC -> TTATGAGCACA
CTTATGCTAGT -> TTATGCTAGTA
CTTCAAAACTA -> TTCAAAACTAA
CTTCAAGATCT -> TTCAAGATCTC
CTTCACATTAC -> TTCACATTACT
CTTCACTCCGG -> TTCACTCCGGC
CTTCCGGAGGG -> TTCCGGAGGGA
CTTCTACCTAG -> TTCTACCTAGC
CTTGAGCGACG -> TTGAGCGACGG
CTTGAGGGACA -> TTGAGGGACAG
CTTGCACGTTA -> TTGCACGTTAT
CTTGCCCCAAT -> TTGCCCCAATA
CTTGTAAAATG -> TTGTAAAATGC
CTTGTCGCAGA -> TTGTCGCAGAT
CTTGTCGTTGA -> TTGTCGTTGAG
CTTGTGTGCCA -> TTGTGTGCCAC
CTTTAGATGTC -> TTTAGATGTCC
CTTTATCGTCG -> TTTATCGTCGT
CTTTCCGAAGA -> TTTCCGAAGAG
CTTTCCTTTGC -> TTTCCTTTGCT
CTTTCTTTGTA -> TTTCTTTGTAT
CTTTGAGGTGC -> TTTGAGGTGCG
CTTTGCCTACG -> TTTGCCTACGA
CTTTGCTCGCG -> TTTGCTCGCGT
CTTTGCTGCCC -> TTTGCTGCCCC
CTTTGTATTTG -> TTTGTATTTGA
CTTTTAGCAGG -> TTTTAGCAGGC
CTTTTGCACCG -> TTTTGCACCGT
GAAAAAGCACA -> AAAAAGCACAT
GAAAATCTGGT -> AAAATCTGGTT
GAAAATTCGGG -> AAAATTCGGGT
GAAAGCGCCAT -> AAAGCGCCATC
GAAAGCGTGTG -> AAAGCGTGTGT
GAAAGGGATAT -> AAAGGGATATA
GAAAGGTTATG -> AAAGGTTATGC
GAACAATACAA -> AACAATACAAA
GAACCATACAG -> AACCATACAGA
GAACGCCTCCT -> AACGCCTCCTA
GAACTACAGAC -> AACTACAGACA
GAACTCCTCAG -> AACTCCTCAGT
GAAGACGTTTC -> AAGACGTTTCC
GAAGAGGAGGA -> AAGAGGAGGAA
GAAGAGGTAGT -> AAGAGGTAGTG
GAAGAGTTATC -> AAGAGTTATCC
GAAGCAGCAAT -> AAGCAGCAATA
GAAGCCAATGT -> AAGCCAATGTT
GAAGCCTGACG -> AAGCCTGACGT
GAAGTAACTTT -> AAGTAACTTTA
GAAGTCATCAA -> AAGTCATCAAG
GAATACCCGTC -> AATACCCGTCT
GAATGTTACAG -> AATGTTACAGG
GACAAACGTCG -> ACAAACGTCGC
GACAACTGGAC -> ACAACTGGACG
GACACCTTAAG -> ACACCTTAAGG
GACACTGACGT -> ACACTGACGTG
GACAGGAGAGC -> ACAGGAGAGCT
GACAGGTATCT -> ACAGGTATCTT
GACAGTAACCA -> ACAGTAACCAC
GACATAACGGA -> ACATAACGGAC
GACATAATGAG -> ACATAATGAGG
GACCAGACATA -> ACCAGACATAA
GACCGCTACCG -> ACCGCTACCGG
GACCGCTGGCA -> ACCGCTGGCAG
GACCTCAGGGA -> ACCTCAGGGAG
GACCTTCACTC -> ACCTTCACTCC
GACGAAGACGT -> ACGAAGACGTT
GACGAGTCCTC -> ACGAGTCCTCG
GACGATATCGG -> ACGATATCGGA
GACGGAAGTAA -> ACGGAAGTAAC
GACGGAAGTCA -> ACGGAAGTCAT
GACGTGAGGTA -> ACGTGAGGTAA
GACGTTCGTTA -> ACGTTCGTTAC
GACGTTTCCGC -> ACGTTTCCGCA
GACTAAAACGA -> ACTAAAACGAA
GACTCATCGAT -> ACTCATCGATT
GACTCCGTCCT -> ACTCCGTCCTC
GACTCGATAGT -> ACTCGATAGTC
GACTGAGCGAC -> ACTGAGCGACC
GACTTACCCAT -> ACTTACCCATC
GACTTTGAGGT -> ACTTTGAGGTG
GAGAAAATTCG -> AGAAAATTCGG
GAGAACAATAC -> AGAACAATACA
GAGAACGCCTC -> AGAACGCCTCC
GAGAAGAGGAG -> AGAAGAGGAGG
GAGACCTCAGG -> AGACCTCAGGG
GAGAGCCTGCC -> AGAGCCTGCCT
GAGAGCTTTTA -> AGAGCTTTTAG
GAGAGTCATCT -> AGAGTCATCTG
GAGATCATTGG -> AGATCATTGGT
GAGATCCCTAG -> AGATCCCTAGG
GAGATTAAGAT -> AGATTAAGATT
GAGCACATGGG -> AGCACATGGGC
GAGCCTGCCTG -> AGCCTGCCTGT
GAGCGACCAGA -> AGCGACCAGAC
GAGCGACGGAA -> AGCGACGGAAG
GAGCGCCGAAC -> AGCGCCGAACC
GAGCGCCGATG -> AGCGCCGATGT
GAGCTTTCTTT -> AGCTTTCTTTG
GAGCTTTTAGC -> AGCTTTTAGCA
GAGGAAGCCAA -> AGGAAGCCAAT
GAGGAGAGTCA -> AGGAGAGTCAT
GAGGAGGAAGC -> AGGAGGAAGCC
GAGGCCCATCA -> AGGCCCATCAG
GAGGCCGGACC -> AGGCCGGACCT
GAGGCGTATCT -> AGGCGTATCTA
GAGGGACAGGT -> AGGGACAGGTA
GAGGGAGGTGT -> AGGGAGGTGTT
GAGGGTGAGTT -> AGGGTGAGTTA
GAGGTAATTAG -> AGGTAATTAGC
GAGGTAGTGTG -> AGGTAGTGTGC
GAGGTGCGCAC -> AGGTGCGCACT
GAGGTGTTTCC -> AGGTGTTTCCC
GAGGTTGAGTC -> AGGTTGAGTCT
GAGTCATCTGC -> AGTCATCTGCC
GAGTCCTCGAA -> AGTCCTCGAAA
GAGTCTTGTGT -> AGTCTTGTGTG
GAGTTACAGGT -> AGTTACAGGTA
GAGTTATCCGA -> AGTTATCCGAA
GAGTTCAGGCC -> AGTTCAGGCCC
GAGTTGGGACG -> AGTTGGGACGA
GATAAAACGTC -> ATAAAACGTCA
GATAATCTCTG -> ATAATCTCTGG
GATACCAATGA -> ATACCAATGAC
GATAGATTGGT -> ATAGATTGGTC
GATAGCCCTAT -> ATAGCCCTATG
GATAGGCATGC -> ATAGGCATGCA
GATAGTCATGG -> ATAGTCATGGT
GATAGTCGATA -> ATAGTCGATAG
GATATACAGTT -> ATATACAGTTA
GATATATCAAT -> ATATATCAATG
GATATCGGAAC -> ATATCGGAACT
GATATGGACAT -> ATATGGACATA
GATCAGAGGCC -> ATCAGAGGCCG
GATCATCAACG -> ATCATCAACGA
GATCATTGGTC -> ATCATTGGTCT
GATCCCTACTG -> ATCCCTACTGT
GATCCCTAGGC -> ATCCCTAGGCC
GATCGACTAAA -> ATCGACTAAAA
GATCGCAACAG -> ATCGCAACAGT
GATCTCTCTTA -> ATCTCTCTTAT
GATGACTCATC -> ATGACTCATCG
GATGGATTAGA -> ATGGATTAGAG
GATGTCAGGGC -> ATGTCAGGGCG
GATGTCCTGCA -> ATGTCCTGCAC
GATTAAGATTC -> ATTAAGATTCG
GATTCCTCGGC -> ATTCCTCGGCA
GATTCGGACTT -> ATTCGGACTTT
GATTCTACCCT -> ATTCTACCCTG
GATTGGTCCCG -> ATTGGTCCCGT
GATTTATGGTG -> ATTTATGGTGT
GCAACAGTTCC -> CAACAGTTCCC
GCAACTGGCAC -> CAACTGGCACT
GCAATAAATTG -> CAATAAATTGC
GCAATCATGTC -> CAATCATGTCA
GCACATGGGCT -> CACATGGGCTG
GCACATGTCCT -> CACATGTCCTT
GCACCGTACGG -> CACCGTACGGA
GCACCTAAATG -> CACCTAAATGT
GCACGCATGTG -> CACGCATGTGC
GCACGGTGATA -> CACGGTGATAG
GCACGGTTCTA -> CACGGTTCTAC
GCACGTCTTTG -> CACGTCTTTGC
GCACGTTATCT -> CACGTTATCTG
GCACTAAGACC -> CACTAAGACCG
GCACTAGGGAT -> CACTAGGGATC
GCACTGCGTGG -> CACTGCGTGGA
GCACTGCTACC -> CACTGCTACCT
GCAGATACCAA -> CAGATACCAAT
GCAGCAATAAA -> CAGCAATAAAT
GCAGCACGGTT -> CAGCACGGTTC
GCAGCCAGAGA -> CAGCCAGAGAC
GCAGCGTGCGG -> CAGCGTGCGGC
GCAGCTGAGTT -> CAGCTGAGTTC
GCAGGCTCTTG -> CAGGCTCTTGA
GCAGTTTAGTA -> CAGTTTAGTAT
GCATAAAAGTT -> CATAAAAGTTT
GCATCCGTCGA -> CATCCGTCGAA
GCATGCATTCT -> CATGCATTCTT
GCATGGCGGTT -> CATGGCGGTTA
GCATGTGCCAG -> CATGTGCCAGG
GCATTCTTATG -> CATTCTTATGC
GCCAATGTTCA -> CCAATGTTCAC
GCCACGCACTG -> CCACGCACTGC
GCCACGTCCCC -> CCACGTCCCCC
GCCAGACAAAC -> CCAGACAAACG
GCCAGAGACCT -> CCAGAGACCTC
GCCAGGCAATC -> CCAGGCAATCA
GCCATATGTCG -> CCATATGTCGC
GCCATCGCTGC -> CCATCGCTGCC
GCCATCGTGCA -> CCATCGTGCAC
GCCCACATCGG -> CCCACATCGGG
GCCCAGTTCGG -> CCCAGTTCGGG
GCCCATCAGGT -> CCCATCAGGTT
GCCCCAAATGA -> CCCCAAATGAT
GCCCCAATACA -> CCCCAATACAC
GCCCCCGTATA -> CCCCCGTATAT
GCCCGGGCCCA -> CCCGGGCCCAC
GCCCGTGCTGC -> CCCGTGCTGCT
GCCCTACGATT -> CCCTACGATTC
GCCCTATGTTG -> CCCTATGTTGT
GCCCTGTTGCG -> CCCTGTTGCGC
GCCGAACCATA -> CCGAACCATAC
GCCGACTTACC -> CCGACTTACCC
GCCGATGTCAG -> CCGATGTCAGG
GCCGGACCTTC -> CCGGACCTTCA
GCCGTCTTTAG -> CCGTCTTTAGA
GCCGTGGCCTT -> CCGTGGCCTTC
GCCGTTCGGGC -> CCGTTCGGGCT
GCCTAAGGGCC -> CCTAAGGGCCC
GCCTACCTAAT -> CCTACCTAATC
GCCTACGACAC -> CCTACGACACT
GCCTCCTAATC -> CCTCCTAATCG
GCCTCTAATGC -> CCTCTAATGCT
GCCTCTGAGGT -> CCTCTGAGGTT
GCCTGACGTTC -> CCTGACGTTCG
GCCTGCCACGC -> CCTGCCACGCA
GCCTGCCCAGT -> CCTGCCCAGTT
GCCTGCCTACC -> CCTGCCTACCT
GCCTGCCTGTC -> CCTGCCTGTCA
GCCTGTAGTTG -> CCTGTAGTTGT
GCCTGTCAAAT -> CCTGTCAAATG
GCCTGTGTCCG -> CCTGTGTCCGT
GCCTTCACATT -> CCTTCACATTA
GCGACCAGACA -> CGACCAGACAT
GCGACGGAAGT -> CGACGGAAGTC
GCGAGATCATT -> CGAGATCATTG
GCGATGACTCA -> CGATGACTCAT
GCGCACTAGGG -> CGCACTAGGGA
GCGCACTGCTA -> CGCACTGCTAC
GCGCAGCTGAG -> CGCAGCTGAGT
GCGCCATCGTG -> CGCCATCGTGC
GCGCCGAACCA -> CGCCGAACCAT
GCGCCGACTTA -> CGCCGACTTAC
GCGCCGATGTC -> CGCCGATGTCA
GCGCGATGACT -> CGCGATGACTC
GCGGATAGCCC -> CGGATAGCCCT
GCGGATATGGA -> CGGATATGGAC
GCGGCTTAAGA -> CGGCTTAAGAC
GCGGGCCCTAC -> CGGGCCCTACG
GCGGGCTGTGC -> CGGGCTGTGCG
GCGGTATGGTT -> CGGTATGGTTA
GCGGTTACATG -> CGGTTACATGG
GCGTACTCATC -> CGTACTCATCA
GCGTATCTACC -> CGTATCTACCC
GCGTCAATGTG -> CGTCAATGTGA
GCGTCAGGCGG -> CGTCAGGCGGG
GCGTGACCGCT -> CGTGACCGCTA
GCGTGCGGCTT -> CGTGCGGCTTA
GCGTGGACTGA -> CGTGGACTGAG
GCGTGTGTCGG -> CGTGTGTCGGT
GCTAAACTAGG -> CTAAACTAGGT
GCTAACCTCTA -> CTAACCTCTAA
GCTACCGGAGG -> CTACCGGAGGC
GCTACCTTTTG -> CTACCTTTTGC
GCTAGTAGCCA -> CTAGTAGCCAT
GCTAGTTTTTA -> CTAGTTTTTAC
GCTCAGAGGGT -> CTCAGAGGGTG
GCTCATGAAAG -> CTCATGAAAGG
GCTCGCGCCGA -> CTCGCGCCGAC
GCTCGCGTCAG -> CTCGCGTCAGG
GCTCGTCGCTC -> CTCGTCGCTCG
GCTCTTGAGCG -> CTCTTGAGCGA
GCTGAGTTCAG -> CTGAGTTCAGG
GCTGCCATATG -> CTGCCATATGT
GCTGCCCCCGT -> CTGCCCCCGTA
GCTGCCCTGTT -> CTGCCCTGTTG
GCTGCTTCAAG -> CTGCTTCAAGA
GCTGGAAAGGG -> CTGGAAAGGGA
GCTGGCAGCCA -> CTGGCAGCCAG
GCTGTGCGCGA -> CTGTGCGCGAT
GCTTAAGACTC -> CTTAAGACTCC
GCTTACGGGCC -> CTTACGGGCCA
GCTTCAAGATC -> CTTCAAGATCT
GCTTCCGGAGG -> CTTCCGGAGGG
GCTTCTACCTA -> CTTCTACCTAG
GCTTGAGGGAC -> CTTGAGGGACA
GCTTTCTTTGT -> CTTTCTTTGTA
GCTTTTAGCAG -> CTTTTAGCAGG
GGAAAGGGATA -> GAAAGGGATAT
GGAACTACAGA -> GAACTACAGAC
GGAAGCCAATG -> GAAGCCAATGT
GGAAGCCTGAC -> GAAGCCTGACG
GGAAGTAACTT -> GAAGTAACTTT
GGAAGTCATCA -> GAAGTCATCAA
GGACAACTGGA -> GACAACTGGAC
GGACAGGTATC -> GACAGGTATCT
GGACATAACGG -> GACATAACGGA
GGACCTTCACT -> GACCTTCACTC
GGACGAAGACG -> GACGAAGACGT
GGACGATATCG -> GACGATATCGG
GGACTGAGCGA -> GACTGAGCGAC
GGACTTTGAGG -> GACTTTGAGGT
GGAGAAAATTC -> GAGAAAATTCG
GGAGAACAATA -> GAGAACAATAC
GGAGAACGCCT -> GAGAACGCCTC
GGAGAAGAGGA -> GAGAAGAGGAG
GGAGAGCTTTT -> GAGAGCTTTTA
GGAGAGTCATC -> GAGAGTCATCT
GGAGGAAGCCA -> GAGGAAGCCAA
GGAGGCCCATC -> GAGGCCCATCA
GGAGGGAGGTG -> GAGGGAGGTGT
GGAGGTGTTTC -> GAGGTGTTTCC
GGAGTTGGGAC -> GAGTTGGGACG
GGATAATCTCT -> GATAATCTCTG
GGATAGCCCTA -> GATAGCCCTAT
GGATATACAGT -> GATATACAGTT
GGATATATCAA -> GATATATCAAT
GGATATGGACA -> GATATGGACAT
GGATCAGAGGC -> GATCAGAGGCC
GGCAATCATGT -> GCAATCATGTC
GGCACGGTGAT -> GCACGGTGATA
GGCACTAAGAC -> GCACTAAGACC
GGCAGCCAGAG -> GCAGCCAGAGA
GGCAGCGTGCG -> GCAGCGTGCGG
GGCATCCGTCG -> GCATCCGTCGA
GGCATGCATTC -> GCATGCATTCT
GGCCAGACAAA -> GCCAGACAAAC
GGCCCACATCG -> GCCCACATCGG
GGCCCATCAGG -> GCCCATCAGGT
GGCCCCAAATG -> GCCCCAAATGA
GGCCCGGGCCC -> GCCCGGGCCCA
GGCCCTACGAT -> GCCCTACGATT
GGCCGGACCTT -> GCCGGACCTTC
GGCCTCTAATG -> GCCTCTAATGC
GGCCTCTGAGG -> GCCTCTGAGGT
GGCCTTCACAT -> GCCTTCACATT
GGCGGATAGCC -> GCGGATAGCCC
GGCGGATATGG -> GCGGATATGGA
GGCGGGCTGTG -> GCGGGCTGTGC
GGCGGTATGGT -> GCGGTATGGTT
GGCGGTTACAT -> GCGGTTACATG
GGCGTATCTAC -> GCGTATCTACC
GGCTAACCTCT -> GCTAACCTCTA
GGCTCGTCGCT -> GCTCGTCGCTC
GGCTCTTGAGC -> GCTCTTGAGCG
GGCTGCCATAT -> GCTGCCATATG
GGCTGTGCGCG -> GCTGTGCGCGA
GGCTTAAGACT -> GCTTAAGACTC
GGCTTACGGGC -> GCTTACGGGCC
GGCTTCCGGAG -> GCTTCCGGAGG
GGGAAGCCTGA -> GGAAGCCTGAC
GGGACAGGTAT -> GGACAGGTATC
GGGACGATATC -> GGACGATATCG
GGGAGAACAAT -> GGAGAACAATA
GGGAGAAGAGG -> GGAGAAGAGGA
GGGAGGTGTTT -> GGAGGTGTTTC
GGGAGTTGGGA -> GGAGTTGGGAC
GGGATATACAG -> GGATATACAGT
GGGATCAGAGG -> GGATCAGAGGC
GGGCCAGACAA -> GGCCAGACAAA
GGGCCCACATC -> GGCCCACATCG
GGGCCCCAAAT -> GGCCCCAAATG
GGGCCCTACGA -> GGCCCTACGAT
GGGCGGATAGC -> GGCGGATAGCC
GGGCGGTATGG -> GGCGGTATGGT
GGGCTGCCATA -> GGCTGCCATAT
GGGCTGTGCGC -> GGCTGTGCGCG
GGGCTTACGGG -> GGCTTACGGGC
GGGGAAGCCTG -> GGGAAGCCTGA
GGGGAGAAGAG -> GGGAGAAGAGG
GGGTAGACTCG -> GGTAGACTCGA
GGGTCGATAAA -> GGTCGATAAAA
GGGTGAGTTAC -> GGTGAGTTACA
GGGTGATCGAC -> GGTGATCGACT
GGGTGGAGAAA -> GGTGGAGAAAA
GGGTGTGCTCA -> GGTGTGCTCAG
GGGTTTGAAGC -> GGTTTGAAGCA
GGTAATTAGCG -> GTAATTAGCGG
GGTAGACTCGA -> GTAGACTCGAT
GGTAGAGAGCC -> GTAGAGAGCCT
GGTAGTGTGCT -> GTAGTGTGCTT
GGTATCTTGCA -> GTATCTTGCAC
GGTATGGTTAC -> GTATGGTTACT
GGTATTTTAGT -> GTATTTTAGTT
GGTCAGTGGGT -> GTCAGTGGGTT
GGTCAGTTAGG -> GTCAGTTAGGT
GGTCCAACCTC -> GTCCAACCTCG
GGTCCCAGTCC -> GTCCCAGTCCA
GGTCCCGTGAA -> GTCCCGTGAAG
GGTCGATAAAA -> GTCGATAAAAC
GGTCTCAGCGT -> GTCTCAGCGTG
GGTGAGTTACA -> GTGAGTTACAG
GGTGATAGGCA -> GTGATAGGCAT
GGTGATCGACT -> GTGATCGACTA
GGTGCGCACTA -> GTGCGCACTAG
GGTGGAGAAAA -> GTGGAGAAAAT
GGTGGCATCCG -> GTGGCATCCGT
GGTGTCTTGCC -> GTGTCTTGCCC
GGTGTGATGGA -> GTGTGATGGAT
GGTGTGCTCAG -> GTGTGCTCAGA
GGTGTTTCCCA -> GTGTTTCCCAA
GGTTAAACAAG -> GTTAAACAAGC
GGTTACATGGG -> GTTACATGGGA
GGTTACTCAGG -> GTTACTCAGGA
GGTTATGCCTG -> GTTATGCCTGC
GGTTCTACCTA -> GTTCTACCTAG
GGTTGAGTCTT -> GTTGAGTCTTG
GGTTTAGGCGG -> GTTTAGGCGGA
GGTTTGAAGCA -> GTTTGAAGCAG
GGTTTGTAAGC -> GTTTGTAAGCC
GGTTTTTGAAA -> GTTTTTGAAAA
GTAAAATGCCG -> TAAAATGCCGT
GTAACCACAGC -> TAACCACAGCC
GTAACTTTATC -> TAACTTTATCG
GTAAGCCTAAG -> TAAGCCTAAGG
GTAATACGTGC -> TAATACGTGCC
GTAATTAGCGG -> TAATTAGCGGG
GTACCGTGATT -> TACCGTGATTT
GTACGGATATA -> TACGGATATAT
GTACTCATCAA -> TACTCATCAAT
GTAGACTCGAT -> TAGACTCGATA
GTAGAGAGCCT -> TAGAGAGCCTG
GTAGCCATCGC -> TAGCCATCGCT
GTAGCTAAACT -> TAGCTAAACTA
GTAGGGTAGAC -> TAGGGTAGACT
GTAGTGTGCTT -> TAGTGTGCTTC
GTAGTTGTAAT -> TAGTTGTAATA
GTATATATGTT -> TATATATGTTA
GTATATCAAGC -> TATATCAAGCT
GTATCTACCCC -> TATCTACCCCC
GTATCTTGCAC -> TATCTTGCACG
GTATGCGAGAT -> TATGCGAGATC
GTATGGTTACT -> TATGGTTACTC
GTATTTGAATG -> TATTTGAATGT
GTATTTGAGAT -> TATTTGAGATC
GTATTTTAGTT -> TATTTTAGTTT
GTCAAATGGCA -> TCAAATGGCAG
GTCAATGTGAT -> TCAATGTGATC
GTCAGGCGGGC -> TCAGGCGGGCT
GTCAGGGCGGT -> TCAGGGCGGTA
GTCAGGTTAAA -> TCAGGTTAAAC
GTCAGTATATA -> TCAGTATATAT
GTCAGTGGGTT -> TCAGTGGGTTT
GTCAGTTAGGT -> TCAGTTAGGTA
GTCATCAAGTA -> TCATCAAGTAG
GTCATCTGCCT -> TCATCTGCCTG
GTCATGGTGTG -> TCATGGTGTGA
GTCCAACCTCG -> TCCAACCTCGT
GTCCACATCAC -> TCCACATCACG
GTCCCAGTCCA -> TCCCAGTCCAC
GTCCCCCTCCA -> TCCCCCTCCAA
GTCCCGTGAAG -> TCCCGTGAAGA
GTCCGTATGCG -> TCCGTATGCGA
GTCCGTGGCTT -> TCCGTGGCTTC
GTCCTCGAAAA -> TCCTCGAAAAA
GTCCTCGGTCA -> TCCTCGGTCAG
GTCCTGCACCT -> TCCTGCACCTA
GTCCTTTGCCT -> TCCTTTGCCTA
GTCGAAAGCGC -> TCGAAAGCGCC
GTCGATAAAAC -> TCGATAAAACG
GTCGATAGATT -> TCGATAGATTG
GTCGCAGATAC -> TCGCAGATACC
GTCGCCTGCCA -> TCGCCTGCCAC
GTCGCGTCAAT -> TCGCGTCAATG
GTCGCTCGCGC -> TCGCTCGCGCC
GTCGGTCCCAG -> TCGGTCCCAGT
GTCGGTTTTTG -> TCGGTTTTTGA
GTCGTACCGTG -> TCGTACCGTGA
GTCGTTGAGCT -> TCGTTGAGCTT
GTCTACACCGA -> TCTACACCGAG
GTCTCAGCGTG -> TCTCAGCGTGA
GTCTTGCCCCA -> TCTTGCCCCAA
GTCTTGTAAAA -> TCTTGTAAAAT
GTCTTGTGTGC -> TCTTGTGTGCC
GTCTTTAGATG -> TCTTTAGATGT
GTCTTTGCTCG -> TCTTTGCTCGC
GTGAAGAGTTA -> TGAAGAGTTAT
GTGACCGCTAC -> TGACCGCTACC
GTGAGGTAATT -> TGAGGTAATTA
GTGAGTTACAG -> TGAGTTACAGG
GTGATAGGCAT -> TGATAGGCATG
GTGATCATCAA -> TGATCATCAAC
GTGATCGACTA -> TGATCGACTAA
GTGATGGATTA -> TGATGGATTAG
GTGATTTATGG -> TGATTTATGGT
GTGCACGTCTT -> TGCACGTCTTT
GTGCCACGTCC -> TGCCACGTCCC
GTGCCAGGCAA -> TGCCAGGCAAT
GTGCCGTTCGG -> TGCCGTTCGGG
GTGCGCACTAG -> TGCGCACTAGG
GTGCGCGATGA -> TGCGCGATGAC
GTGCGGCTTAA -> TGCGGCTTAAG
GTGCTCAGAGG -> TGCTCAGAGGG
GTGCTGCTTCA -> TGCTGCTTCAA
GTGCTTCTACC -> TGCTTCTACCT
GTGGACTGAGC -> TGGACTGAGCG
GTGGAGAAAAT -> TGGAGAAAATT
GTGGCATCCGT -> TGGCATCCGTC
GTGGCCTTCAC -> TGGCCTTCACA
GTGGCTTCCGG -> TGGCTTCCGGA
GTGGGGAAGCC -> TGGGGAAGCCT
GTGGGTTTGAA -> TGGGTTTGAAG
GTGTCCGTGGC -> TGTCCGTGGCT
GTGTCGGTCCC -> TGTCGGTCCCA
GTGTCTTGCCC -> TGTCTTGCCCC
GTGTGATGGAT -> TGTGATGGATT
GTGTGCCACGT -> TGTGCCACGTC
GTGTGCTCAGA -> TGTGCTCAGAG
GTGTGCTTCTA -> TGTGCTTCTAC
GTGTGTCGGTC -> TGTGTCGGTCC
GTGTTTCCCAA -> TGTTTCCCAAA
GTTAAACAAGC -> TTAAACAAGCC
GTTAACTTGTC -> TTAACTTGTCG
GTTAAGACGAG -> TTAAGACGAGT
GTTACAGGTAG -> TTACAGGTAGA
GTTACAGGTCC -> TTACAGGTCCA
GTTACATGGGA -> TTACATGGGAG
GTTACTCAGGA -> TTACTCAGGAG
GTTACTGATCC -> TTACTGATCCC
GTTACTGGGTG -> TTACTGGGTGT
GTTAGCGCAGC -> TTAGCGCAGCT
GTTAGGTATTT -> TTAGGTATTTT
GTTATCCGAAC -> TTATCCGAACT
GTTATCTGTTG -> TTATCTGTTGA
GTTATGCCTGC -> TTATGCCTGCC
GTTCACTCGAT -> TTCACTCGATA
GTTCAGGCCCG -> TTCAGGCCCGG
GTTCCCGTAGG -> TTCCCGTAGGG
GTTCGGGCTTA -> TTCGGGCTTAC
GTTCGGGTGAT -> TTCGGGTGATC
GTTCGTTACTG -> TTCGTTACTGA
GTTCTACCTAG -> TTCTACCTAGC
GTTGACAGGAG -> TTGACAGGAGA
GTTGAGCTTTC -> TTGAGCTTTCT
GTTGAGTCTTG -> TTGAGTCTTGT
GTTGCGCACTG -> TTGCGCACTGC
GTTGGGACGAT -> TTGGGACGATA
GTTGTAATACG -> TTGTAATACGT
GTTGTTAACTT -> TTGTTAACTTG
GTTTAACCGGC -> TTTAACCGGCT
GTTTACCTCCT -> TTTACCTCCTT
GTTTAGGCGGA -> TTTAGGCGGAT
GTTTAGTATTT -> TTTAGTATTTG
GTTTATACTGG -> TTTATACTGGA
GTTTCCCAAAA -> TTTCCCAAAAA
GTTTCCGCAGC -> TTTCCGCAGCA
GTTTGAAGCAG -> TTTGAAGCAGC
GTTTGTAAGCC -> TTTGTAAGCCT
GTTTTTACTCA -> TTTTTACTCAG
GTTTTTGAAAA -> TTTTTGAAAAT
TAAAACGAAAG -> AAAACGAAAGC
TAAAACGTCAG -> AAAACGTCAGG
TAAAAGTTTAC -> AAAAGTTTACC
TAAAATGCCGT -> AAAATGCCGTC
TAAACAAGCCC -> AAACAAGCCCG
TAAACTAGGTG -> AAACTAGGTGG
TAAATGTCTAC -> AAATGTCTACA
TAAATTGCAGT -> AAATTGCAGTT
TAACAGCATAA -> AACAGCATAAA
TAACCACAGCC -> AACCACAGCCT
TAACCGGCTAA -> AACCGGCTAAC
TAACCTCTAAC -> AACCTCTAACA
TAACGGACAAC -> AACGGACAACT
TAACTTGTCGC -> AACTTGTCGCA
TAACTTTATCG -> AACTTTATCGT
TAAGACCGCTG -> AAGACCGCTGG
TAAGACGAGTC -> AAGACGAGTCC
TAAGACTCCGT -> AAGACTCCGTC
TAAGATTCGGA -> AAGATTCGGAC
TAAGCCTAAGG -> AAGCCTAAGGG
TAAGGGCCCCA -> AAGGGCCCCAA
TAAGGGGAGAA -> AAGGGGAGAAG
TAATACGTGCC -> AATACGTGCCG
TAATCGTGGGG -> AATCGTGGGGA
TAATCTCTGGC -> AATCTCTGGCC
TAATCTTTCCG -> AATCTTTCCGA
TAATGAGGCGT -> AATGAGGCGTA
TAATGCTCATG -> AATGCTCATGA
TAATTACCTTT -> AATTACCTTTC
TAATTAGCGGG -> AATTAGCGGGC
TACAAAAGGTC -> ACAAAAGGTCA
TACACCGAGCG -> ACACCGAGCGC
TACACGACAGT -> ACACGACAGTA
TACAGACACCT -> ACAGACACCTT
TACAGAGGAGA -> ACAGAGGAGAG
TACAGGTAGAG -> ACAGGTAGAGA
TACAGGTCCAA -> ACAGGTCCAAC
TACAGTTAGCG -> ACAGTTAGCGC
TACATGGGAGT -> ACATGGGAGTT
TACCAATGACG -> ACCAATGACGG
TACCCATCTAT -> ACCCATCTATT
TACCCCCCCGC -> ACCCCCCCGCT
TACCCGTCTTG -> ACCCGTCTTGT
TACCCTGCGTA -> ACCCTGCGTAC
TACCGGAGGCC -> ACCGGAGGCCC
TACCGTGATTT -> ACCGTGATTTA
TACCTAATCTT -> ACCTAATCTTT
TACCTAGCAAC -> ACCTAGCAACT
TACCTAGCCGT -> ACCTAGCCGTG
TACCTCCTTGT -> ACCTCCTTGTC
TACCTTTCCTT -> ACCTTTCCTTT
TACCTTTTGCA -> ACCTTTTGCAC
TACGACACTGA -> ACGACACTGAC
TACGATTCTAC -> ACGATTCTACC
TACGGATATAT -> ACGGATATATC
TACGGGCCAGA -> ACGGGCCAGAC
TACGTGCCGTT -> ACGTGCCGTTC
TACTCAGAGCG -> ACTCAGAGCGC
TACTCAGGAGA -> ACTCAGGAGAA
TACTCATCAAT -> ACTCATCAATT
TACTGATCCCT -> ACTGATCCCTA
TACTGGATAAT -> ACTGGATAATC
TACTGGGTGTG -> ACTGGGTGTGC
TACTGTTAAGA -> ACTGTTAAGAC
TACTTCAAAAC -> ACTTCAAAACT
TAGACTCGATA -> AGACTCGATAG
TAGAGAGCCTG -> AGAGAGCCTGC
TAGATGTCCTG -> AGATGTCCTGC
TAGATTGGTCC -> AGATTGGTCCC
TAGCAACTGGC -> AGCAACTGGCA
TAGCAGGCTCT -> AGCAGGCTCTT
TAGCCATCGCT -> AGCCATCGCTG
TAGCCCTATGT -> AGCCCTATGTT
TAGCCGTGGCC -> AGCCGTGGCCT
TAGCGCAGCTG -> AGCGCAGCTGA
TAGCGGGCCCT -> AGCGGGCCCTA
TAGCTAAACTA -> AGCTAAACTAG
TAGGCATGCAT -> AGGCATGCATT
TAGGCCTCTGA -> AGGCCTCTGAG
TAGGCGGATAT -> AGGCGGATATG
TAGGGATCAGA -> AGGGATCAGAG
TAGGGTAGACT -> AGGGTAGACTC
TAGGTATTTTA -> AGGTATTTTAG
TAGGTGGCATC -> AGGTGGCATCC
TAGTAGCCATC -> AGTAGCCATCG
TAGTATTTGAG -> AGTATTTGAGA
TAGTCATGGTG -> AGTCATGGTGT
TAGTCGATAGA -> AGTCGATAGAT
TAGTGTGCTTC -> AGTGTGCTTCT
TAGTTGTAATA -> AGTTGTAATAC
TAGTTTAACCG -> AGTTTAACCGG
TAGTTTTTACT -> AGTTTTTACTC
TATACAGTTAG -> ATACAGTTAGC
TATACTGGATA -> ATACTGGATAA
TATATATGTTA -> ATATATGTTAC
TATATCAAGCT -> ATATCAAGCTG
TATATCAATGC -> ATATCAATGCT
TATATGTTACT -> ATATGTTACTG
TATCAAGCTGG -> ATCAAGCTGGA
TATCAATGCTA -> ATCAATGCTAG
TATCCGAACTC -> ATCCGAACTCC
TATCGGAACTA -> ATCGGAACTAC
TATCGTCGTAC -> ATCGTCGTACC
TATCTACCCCC -> ATCTACCCCCC
TATCTGTTGAC -> ATCTGTTGACA
TATCTTGCACG -> ATCTTGCACGT
TATGAGCACAT -> ATGAGCACATG
TATGCCTGCCC -> ATGCCTGCCCA
TATGCGAGATC -> ATGCGAGATCA
TATGCTAGTAG -> ATGCTAGTAGC
TATGGACATAA -> ATGGACATAAC
TATGGTGTCTT -> ATGGTGTCTTG
TATGGTTACTC -> ATGGTTACTCA
TATGTCGCGTC -> ATGTCGCGTCA
TATGTTACTGG -> ATGTTACTGGG
TATGTTGTTAA -> ATGTTGTTAAC
TATTGCACGCA -> ATTGCACGCAT
TATTTGAATGT -> ATTTGAATGTT
TATTTGAGATC -> ATTTGAGATCC
TATTTTAGTTT -> ATTTTAGTTTA
TCAAAACTAAT -> CAAAACTAATT
TCAAATGGCAG -> CAAATGGCAGC
TCAACGAGATT -> CAACGAGATTA
TCAAGATCTCT -> CAAGATCTCTC
TCAAGCTGGAA -> CAAGCTGGAAA
TCAAGTAGCTA -> CAAGTAGCTAA
TCAATGCTAGT -> CAATGCTAGTT
TCAATGTGATC -> CAATGTGATCA
TCAATTGTCCG -> CAATTGTCCGT
TCACATTACTT -> CACATTACTTC
TCACGCCTGCC -> CACGCCTGCCT
TCACTCCGGCT -> CACTCCGGCTC
TCACTCGATAG -> CACTCGATAGT
TCAGAGCGCCG -> CAGAGCGCCGA
TCAGAGGCCGG -> CAGAGGCCGGA
TCAGAGGGTGA -> CAGAGGGTGAG
TCAGCGTGACC -> CAGCGTGACCG
TCAGGAGAACG -> CAGGAGAACGC
TCAGGCCCGGG -> CAGGCCCGGGC
TCAGGCGGGCT -> CAGGCGGGCTG
TCAGGGAGAAC -> CAGGGAGAACA
TCAGGGCGGTA -> CAGGGCGGTAT
TCAGGTTAAAC -> CAGGTTAAACA
TCAGGTTTAGG -> CAGGTTTAGGC
TCAGTATATAT -> CAGTATATATG
TCAGTGGGTTT -> CAGTGGGTTTG
TCAGTTAGGTA -> CAGTTAGGTAT
TCAGTTTATAC -> CAGTTTATACT
TCATCAACGAG -> CATCAACGAGA
TCATCAAGTAG -> CATCAAGTAGC
TCATCAATTGT -> CATCAATTGTC
TCATCGATTCC -> CATCGATTCCT
TCATCTGCCTG -> CATCTGCCTGT
TCATGAAAGGT -> CATGAAAGGTT
TCATGGTGTGA -> CATGGTGTGAT
TCATGTCAGTA -> CATGTCAGTAT
TCATTGGTCTC -> CATTGGTCTCA
TCCAACCATGA -> CCAACCATGAA
TCCAACCTCGT -> CCAACCTCGTC
TCCACATCACG -> CCACATCACGC
TCCCAAAAAGG -> CCCAAAAAGGG
TCCCAGTCCAC -> CCCAGTCCACA
TCCCCCTCCAA -> CCCCCTCCAAC
TCCCGTAGGGT -> CCCGTAGGGTA
TCCCGTGAAGA -> CCCGTGAAGAG
TCCCTACTGTT -> CCCTACTGTTA
TCCCTAGGCCT -> CCCTAGGCCTC
TCCGAACTCCT -> CCGAACTCCTC
TCCGAAGAGGT -> CCGAAGAGGTA
TCCGCAGCACG -> CCGCAGCACGG
TCCGGAGGGAG -> CCGGAGGGAGG
TCCGGCTCGTC -> CCGGCTCGTCG
TCCGTATGCGA -> CCGTATGCGAG
TCCGTCCTCGG -> CCGTCCTCGGT
TCCGTCGAAAG -> CCGTCGAAAGC
TCCGTGGCTTC -> CCGTGGCTTCC
TCCTAATCGTG -> CCTAATCGTGG
TCCTCAGTTTA -> CCTCAGTTTAT
TCCTCGAAAAA -> CCTCGAAAAAG
TCCTCGGCACG -> CCTCGGCACGG
TCCTCGGTCAG -> CCTCGGTCAGT
TCCTGCACCTA -> CCTGCACCTAA
TCCTTGTCGTT -> CCTTGTCGTTG
TCCTTTGCCTA -> CCTTTGCCTAC
TCCTTTGCTGC -> CCTTTGCTGCC
TCGAAAAAGCA -> CGAAAAAGCAC
TCGAAAGCGCC -> CGAAAGCGCCA
TCGACTAAAAC -> CGACTAAAACG
TCGATAAAACG -> CGATAAAACGT
TCGATAGATTG -> CGATAGATTGG
TCGATAGTCAT -> CGATAGTCATG
TCGATAGTCGA -> CGATAGTCGAT
TCGATTCCTCG -> CGATTCCTCGG
TCGCAACAGTT -> CGCAACAGTTC
TCGCAGATACC -> CGCAGATACCA
TCGCCTGCCAC -> CGCCTGCCACG
TCGCGCCGACT -> CGCGCCGACTT
TCGCGTCAATG -> CGCGTCAATGT
TCGCGTCAGGC -> CGCGTCAGGCG
TCGCTCGCGCC -> CGCTCGCGCCG
TCGCTGCCCTG -> CGCTGCCCTGT
TCGGAACTACA -> CGGAACTACAG
TCGGACTTTGA -> CGGACTTTGAG
TCGGCACGGTG -> CGGCACGGTGA
TCGGGCGGATA -> CGGGCGGATAG
TCGGGCTTACG -> CGGGCTTACGG
TCGGGTCGATA -> CGGGTCGATAA
TCGGGTGATCG -> CGGGTGATCGA
TCGGTCAGTTA -> CGGTCAGTTAG
TCGGTCCCAGT -> CGGTCCCAGTC
TCGGTTTTTGA -> CGGTTTTTGAA
TCGTACCGTGA -> CGTACCGTGAT
TCGTCGCTCGC -> CGTCGCTCGCG
TCGTCGGTTTT -> CGTCGGTTTTT
TCGTCGTACCG -> CGTCGTACCGT
TCGTGCACGTC -> CGTGCACGTCT
TCGTGGGGAAG -> CGTGGGGAAGC
TCGTTACTGAT -> CGTTACTGATC
TCGTTGAGCTT -> CGTTGAGCTTT
TCTAACAGCAT -> CTAACAGCATA
TCTAATGCTCA -> CTAATGCTCAT
TCTACACCGAG -> CTACACCGAGC
TCTACCCCCCC -> CTACCCCCCCG
TCTACCCTGCG -> CTACCCTGCGT
TCTACCTAGCA -> CTACCTAGCAA
TCTACCTAGCC -> CTACCTAGCCG
TCTATTGCACG -> CTATTGCACGC
TCTCAGCGTGA -> CTCAGCGTGAC
TCTCTCTTATG -> CTCTCTTATGA
TCTCTGGCCTC -> CTCTGGCCTCT
TCTCTTATGAG -> CTCTTATGAGC
TCTGAGGTTGA -> CTGAGGTTGAG
TCTGCCTGTGT -> CTGCCTGTGTC
TCTGGCCTCTA -> CTGGCCTCTAA
TCTGGTTTGTA -> CTGGTTTGTAA
TCTGTTGACAG -> CTGTTGACAGG
TCTTATGAGCA -> CTTATGAGCAC
TCTTATGCTAG -> CTTATGCTAGT
TCTTGAGCGAC -> CTTGAGCGACG
TCTTGCACGTT -> CTTGCACGTTA
TCTTGCCCCAA -> CTTGCCCCAAT
TCTTGTAAAAT -> CTTGTAAAATG
TCTTGTGTGCC -> CTTGTGTGCCA
TCTTTAGATGT -> CTTTAGATGTC
TCTTTCCGAAG -> CTTTCCGAAGA
TCTTTGCTCGC -> CTTTGCTCGCG
TCTTTGTATTT -> CTTTGTATTTG
TGAAAATCTGG -> GAAAATCTGGT
TGAAAGGTTAT -> GAAAGGTTATG
TGAAGAGTTAT -> GAAGAGTTATC
TGAAGCAGCAA -> GAAGCAGCAAT
TGAATACCCGT -> GAATACCCGTC
TGAATGTTACA -> GAATGTTACAG
TGACAGGAGAG -> GACAGGAGAGC
TGACCGCTACC -> GACCGCTACCG
TGACGGAAGTA -> GACGGAAGTAA
TGACGTGAGGT -> GACGTGAGGTA
TGACGTTCGTT -> GACGTTCGTTA
TGACTCATCGA -> GACTCATCGAT
TGAGATCCCTA -> GAGATCCCTAG
TGAGCACATGG -> GAGCACATGGG
TGAGCGACCAG -> GAGCGACCAGA
TGAGCGACGGA -> GAGCGACGGAA
TGAGCTTTCTT -> GAGCTTTCTTT
TGAGGCGTATC -> GAGGCGTATCT
TGAGGGACAGG -> GAGGGACAGGT
TGAGGTAATTA -> GAGGTAATTAG
TGAGGTGCGCA -> GAGGTGCGCAC
TGAGGTTGAGT -> GAGGTTGAGTC
TGAGTCTTGTG -> GAGTCTTGTGT
TGAGTTACAGG -> GAGTTACAGGT
TGAGTTCAGGC -> GAGTTCAGGCC
TGATAGGCATG -> GATAGGCATGC
TGATCATCAAC -> GATCATCAACG
TGATCCCTACT -> GATCCCTACTG
TGATCGACTAA -> GATCGACTAAA
TGATCGCAACA -> GATCGCAACAG
TGATGGATTAG -> GATGGATTAGA
TGATTTATGGT -> GATTTATGGTG
TGCACCGTACG -> GCACCGTACGG
TGCACCTAAAT -> GCACCTAAATG
TGCACGCATGT -> GCACGCATGTG
TGCACGTCTTT -> GCACGTCTTTG
TGCACGTTATC -> GCACGTTATCT
TGCAGTTTAGT -> GCAGTTTAGTA
TGCATGGCGGT -> GCATGGCGGTT
TGCATTCTTAT -> GCATTCTTATG
TGCCACGCACT -> GCCACGCACTG
TGCCACGTCCC -> GCCACGTCCCC
TGCCAGGCAAT -> GCCAGGCAATC
TGCCATATGTC -> GCCATATGTCG
TGCCCAGTTCG -> GCCCAGTTCGG
TGCCCCAATAC -> GCCCCAATACA
TGCCCCCGTAT -> GCCCCCGTATA
TGCCCTGTTGC -> GCCCTGTTGCG
TGCCGTCTTTA -> GCCGTCTTTAG
TGCCGTTCGGG -> GCCGTTCGGGC
TGCCTACCTAA -> GCCTACCTAAT
TGCCTACGACA -> GCCTACGACAC
TGCCTGCCCAG -> GCCTGCCCAGT
TGCCTGTCAAA -> GCCTGTCAAAT
TGCCTGTGTCC -> GCCTGTGTCCG
TGCGAGATCAT -> GCGAGATCATT
TGCGCACTAGG -> GCGCACTAGGG
TGCGCACTGCT -> GCGCACTGCTA
TGCGCGATGAC -> GCGCGATGACT
TGCGGCTTAAG -> GCGGCTTAAGA
TGCGTACTCAT -> GCGTACTCATC
TGCGTGGACTG -> GCGTGGACTGA
TGCTACCTTTT -> GCTACCTTTTG
TGCTAGTAGCC -> GCTAGTAGCCA
TGCTAGTTTTT -> GCTAGTTTTTA
TGCTCAGAGGG -> GCTCAGAGGGT
TGCTCATGAAA -> GCTCATGAAAG
TGCTCGCGTCA -> GCTCGCGTCAG
TGCTGCCCCCG -> GCTGCCCCCGT
TGCTGCTTCAA -> GCTGCTTCAAG
TGCTTCAAGAT -> GCTTCAAGATC
TGCTTCTACCT -> GCTTCTACCTA
TGGAAAGGGAT -> GGAAAGGGATA
TGGACATAACG -> GGACATAACGG
TGGACGAAGAC -> GGACGAAGACG
TGGACTGAGCG -> GGACTGAGCGA
TGGAGAAAATT -> GGAGAAAATTC
TGGATAATCTC -> GGATAATCTCT
TGGCACTAAGA -> GGCACTAAGAC
TGGCAGCCAGA -> GGCAGCCAGAG
TGGCAGCGTGC -> GGCAGCGTGCG
TGGCATCCGTC -> GGCATCCGTCG
TGGCCTCTAAT -> GGCCTCTAATG
TGGCCTTCACA -> GGCCTTCACAT
TGGCGGTTACA -> GGCGGTTACAT
TGGCTTCCGGA -> GGCTTCCGGAG
TGGGACGATAT -> GGGACGATATC
TGGGAGTTGGG -> GGGAGTTGGGA
TGGGCTGCCAT -> GGGCTGCCATA
TGGGGAAGCCT -> GGGGAAGCCTG
TGGGTGTGCTC -> GGGTGTGCTCA
TGGGTTTGAAG -> GGGTTTGAAGC
TGGTCCCGTGA -> GGTCCCGTGAA
TGGTCTCAGCG -> GGTCTCAGCGT
TGGTGTCTTGC -> GGTGTCTTGCC
TGGTGTGATGG -> GGTGTGATGGA
TGGTTACTCAG -> GGTTACTCAGG
TGGTTTGTAAG -> GGTTTGTAAGC
TGTAAAATGCC -> GTAAAATGCCG
TGTAAGCCTAA -> GTAAGCCTAAG
TGTAATACGTG -> GTAATACGTGC
TGTAGTTGTAA -> GTAGTTGTAAT
TGTATTTGAAT -> GTATTTGAATG
TGTCAAATGGC -> GTCAAATGGCA
TGTCAGGGCGG -> GTCAGGGCGGT
TGTCAGTATAT -> GTCAGTATATA
TGTCCGTATGC -> GTCCGTATGCG
TGTCCGTGGCT -> GTCCGTGGCTT
TGTCCTGCACC -> GTCCTGCACCT
TGTCCTTTGCC -> GTCCTTTGCCT
TGTCGCAGATA -> GTCGCAGATAC
TGTCGCGTCAA -> GTCGCGTCAAT
TGTCGGTCCCA -> GTCGGTCCCAG
TGTCGTTGAGC -> GTCGTTGAGCT
TGTCTACACCG -> GTCTACACCGA
TGTCTTGCCCC -> GTCTTGCCCCA
TGTGATCATCA -> GTGATCATCAA
TGTGATGGATT -> GTGATGGATTA
TGTGCCACGTC -> GTGCCACGTCC
TGTGCCAGGCA -> GTGCCAGGCAA
TGTGCGCGATG -> GTGCGCGATGA
TGTGCTCAGAG -> GTGCTCAGAGG
TGTGCTTCTAC -> GTGCTTCTACC
TGTGTCCGTGG -> GTGTCCGTGGC
TGTGTCGGTCC -> GTGTCGGTCCC
TGTGTGCCACG -> GTGTGCCACGT
TGTTAACTTGT -> GTTAACTTGTC
TGTTAAGACGA -> GTTAAGACGAG
TGTTACAGGTC -> GTTACAGGTCC
TGTTACTGGGT -> GTTACTGGGTG
TGTTCACTCGA -> GTTCACTCGAT
TGTTGACAGGA -> GTTGACAGGAG
TGTTGCGCACT -> GTTGCGCACTG
TGTTGTTAACT -> GTTGTTAACTT
TGTTTCCCAAA -> GTTTCCCAAAA
TTAAACAAGCC -> TAAACAAGCCC
TTAACCGGCTA -> TAACCGGCTAA
TTAACTTGTCG -> TAACTTGTCGC
TTAAGACGAGT -> TAAGACGAGTC
TTAAGACTCCG -> TAAGACTCCGT
TTAAGATTCGG -> TAAGATTCGGA
TTAAGGGGAGA -> TAAGGGGAGAA
TTACAGGTAGA -> TACAGGTAGAG
TTACAGGTCCA -> TACAGGTCCAA
TTACATGGGAG -> TACATGGGAGT
TTACCCATCTA -> TACCCATCTAT
TTACCTCCTTG -> TACCTCCTTGT
TTACCTTTCCT -> TACCTTTCCTT
TTACGGGCCAG -> TACGGGCCAGA
TTACTCAGAGC -> TACTCAGAGCG
TTACTCAGGAG -> TACTCAGGAGA
TTACTGATCCC -> TACTGATCCCT
TTACTGGGTGT -> TACTGGGTGTG
TTACTTCAAAA -> TACTTCAAAAC
TTAGATGTCCT -> TAGATGTCCTG
TTAGCAGGCTC -> TAGCAGGCTCT
TTAGCGCAGCT -> TAGCGCAGCTG
TTAGCGGGCCC -> TAGCGGGCCCT
TTAGGCGGATA -> TAGGCGGATAT
TTAGGTATTTT -> TAGGTATTTTA
TTAGTATTTGA -> TAGTATTTGAG
TTAGTTTAACC -> TAGTTTAACCG
TTATACTGGAT -> TATACTGGATA
TTATCCGAACT -> TATCCGAACTC
TTATCGTCGTA -> TATCGTCGTAC
TTATCTGTTGA -> TATCTGTTGAC
TTATGAGCACA -> TATGAGCACAT
TTATGCCTGCC -> TATGCCTGCCC
TTATGCTAGTA -> TATGCTAGTAG
TTATGGTGTCT -> TATGGTGTCTT
TTCAAAACTAA -> TCAAAACTAAT
TTCAAGATCTC -> TCAAGATCTCT
TTCACATTACT -> TCACATTACTT
TTCACTCCGGC -> TCACTCCGGCT
TTCACTCGATA -> TCACTCGATAG
TTCAGGCCCGG -> TCAGGCCCGGG
TTCCCAAAAAG -> TCCCAAAAAGG
TTCCCGTAGGG -> TCCCGTAGGGT
TTCCGAAGAGG -> TCCGAAGAGGT
TTCCGCAGCAC -> TCCGCAGCACG
TTCCGGAGGGA -> TCCGGAGGGAG
TTCCTCGGCAC -> TCCTCGGCACG
TTCCTTTGCTG -> TCCTTTGCTGC
TTCGGACTTTG -> TCGGACTTTGA
TTCGGGCTTAC -> TCGGGCTTACG
TTCGGGTCGAT -> TCGGGTCGATA
TTCGGGTGATC -> TCGGGTGATCG
TTCGTTACTGA -> TCGTTACTGAT
TTCTACCCTGC -> TCTACCCTGCG
TTCTACCTAGC -> TCTACCTAGCA,TCTACCTAGCC
TTCTTATGCTA -> TCTTATGCTAG
TTCTTTGTATT -> TCTTTGTATTT
TTGAAAATCTG -> TGAAAATCTGG
TTGAAGCAGCA -> TGAAGCAGCAA
TTGAATGTTAC -> TGAATGTTACA
TTGACAGGAGA -> TGACAGGAGAG
TTGAGATCCCT -> TGAGATCCCTA
TTGAGCGACGG -> TGAGCGACGGA
TTGAGCTTTCT -> TGAGCTTTCTT
TTGAGGGACAG -> TGAGGGACAGG
TTGAGGTGCGC -> TGAGGTGCGCA
TTGAGTCTTGT -> TGAGTCTTGTG
TTGCACCGTAC -> TGCACCGTACG
TTGCACGCATG -> TGCACGCATGT
TTGCACGTTAT -> TGCACGTTATC
TTGCAGTTTAG -> TGCAGTTTAGT
TTGCCCCAATA -> TGCCCCAATAC
TTGCCTACGAC -> TGCCTACGACA
TTGCGCACTGC -> TGCGCACTGCT
TTGCTCGCGTC -> TGCTCGCGTCA
TTGCTGCCCCC -> TGCTGCCCCCG
TTGGGACGATA -> TGGGACGATAT
TTGGTCCCGTG -> TGGTCCCGTGA
TTGGTCTCAGC -> TGGTCTCAGCG
TTGTAAAATGC -> TGTAAAATGCC
TTGTAAGCCTA -> TGTAAGCCTAA
TTGTAATACGT -> TGTAATACGTG
TTGTATTTGAA -> TGTATTTGAAT
TTGTCCGTATG -> TGTCCGTATGC
TTGTCGCAGAT -> TGTCGCAGATA
TTGTCGTTGAG -> TGTCGTTGAGC
TTGTGTGCCAC -> TGTGTGCCACG
TTGTTAACTTG -> TGTTAACTTGT
TTTAACCGGCT -> TTAACCGGCTA
TTTACCTCCTT -> TTACCTCCTTG
TTTACTCAGAG -> TTACTCAGAGC
TTTAGATGTCC -> TTAGATGTCCT
TTTAGCAGGCT -> TTAGCAGGCTC
TTTAGGCGGAT -> TTAGGCGGATA
TTTAGTATTTG -> TTAGTATTTGA
TTTAGTTTAAC -> TTAGTTTAACC
TTTATACTGGA -> TTATACTGGAT
TTTATCGTCGT -> TTATCGTCGTA
TTTATGGTGTC -> TTATGGTGTCT
TTTCCCAAAAA -> TTCCCAAAAAG
TTTCCGAAGAG -> TTCCGAAGAGG
TTTCCGCAGCA -> TTCCGCAGCAC
TTTCCTTTGCT -> TTCCTTTGCTG
TTTCTTTGTAT -> TTCTTTGTATT
TTTGAAAATCT -> TTGAAAATCTG
TTTGAAGCAGC -> TTGAAGCAGCA
TTTGAATGTTA -> TTGAATGTTAC
TTTGAGATCCC -> TTGAGATCCCT
TTTGAGGTGCG -> TTGAGGTGCGC
TTTGCACCGTA -> TTGCACCGTAC
TTTGCCTACGA -> TTGCCTACGAC
TTTGCTCGCGT -> TTGCTCGCGTC
TTTGCTGCCCC -> TTGCTGCCCCC
TTTGTAAGCCT -> TTGTAAGCCTA
TTTGTATTTGA -> TTGTATTTGAA
TTTTACTCAGA -> TTTACTCAGAG
TTTTAGCAGGC -> TTTAGCAGGCT
TTTTAGTTTAA -> TTTAGTTTAAC
TTTTGAAAATC -> TTTGAAAATCT
TTTTGCACCGT -> TTTGCACCGTA
TTTTTACTCAG -> TTTTACTCAGA
TTTTTGAAAAT -> TTTTGAAAATC