30 100
CAACAGAACAGCGACGATAACGATCCTTAG|GTCTCGCTGGGCGCACCACCGACTCACCGC
TACCACACACTTACAACAGAACTGGCCTTG|CGTTACCACACACTTACAACAGAACTCGGT
GTTCGAACTAAACCTGCATGAAAAGCGTTG|CCGTTATCAGTGGATAGCACCACCGGTTTG
TTGAACGTTACCACACACTTACAACAGAAC|TACAACAGAACGCTTGTTCGGAGGACCCGA
CTTCACAGAATTGAACGTTACCACACACTT|ACGATCCTTAGACAGGGTCGTCCGAAGCTG
CTTACAACAGAACTCTATTGAACGTTACCA|GTTTCACGGTGACGGGGTTCCTTCACAGAA
AACAGCGACGATAACGATCCTTAGACAGGG|CTGGGCGCACCACCGACTCACCGCACGCTC
GAACGCTTGTTCGGAGGACCCGATCAGAGA|TCATCTATGCAGGTCCAATAGTTAACTTTA
CACACTTACAACAGAACTAGTCCACACCAG|AGGAACCGAGACGCTTGAACGTTACCACAC
ACGTTACCACACACTTACAACAGAACTAGT|CAGAACCTCAGGAACCGAGACGCTTGAACG
TACAACAGAACGCTTGTTCGGAGGACCCGA|CTCATGCTCATCTATGCAGGTCCAATAGTT
CGGGGTTCCTTCACAGAATTGAACGTTACC|CGACGATAACGATCCTTAGACAGGGTCGTC
TTGAACGTTACCACACACTTACAACAGAAC|AAGCGTTGGAACGGGTAGGGAGAGTTGAAC
GTCTCGCTGGGCGCACCACCGACTCACCGC|GGAGAGCATGCTGACCGGGCGTCCACCCTG
CACTTACAACAGAACTCTATTGAACGTTAC|TTGTTTCACGGTGACGGGGTTCCTTCACAG
TTTGAACGTTACCACACACTTACAACAGAA|TTGAATAGGTGTTTCAGGTTCTGGGGATCC
GTCATAATAAGTCCAGACGACTGATAAGTG|CTTTCGCAAACGATGCACATTCTAATAAGG
GTTTCCTCCCATTGGCAGTGAAGGCACGGT|AACAGAACTCTATTGAACGTTACCACACAC
AGACGCTTGAACGTTACCACACACTTACAA|CACTTACAACAGAACTGGCCTTGTCCTCAT
ACCCTGGTTCAGAAGATCTAGCTTGAACGT|ACCACACACTTACAACAGAACTACAACAGA
CACACACTTACAACAGAACTCTATTGAACG|GCCCTTGTTTCACGGTGACGGGGTTCCTTC
TAAACGGGAGAGCATGCTGACCGGGCGTCC|TGTTGAACGTTACCACACACTTTGAACGTT
GGAACGGGTAGGGAGAGTTGAACGTTACCA|GAACGTTACCACACACTTACAACAGAACGG
ATTGCTGTGAATTCTAGCGCACCGACATCC|AGTCTCAAGAGCGCAGAGGACCAACCAGGC
ACACTTATGTGCCCTTGTTTCACGGTGACG|ACGTTACCACACACTTACAACAGAACAGCG
CTTTATGGTAAACACGACTGGTCGAACGTA|ACCTAGAACCTTCCGTCGGGGAACTCCTTG
ACATCCAGGCTGATACATAGGGCCCAATGT|CCAGGCTATTGTTGAACGTTACCACACACT
AACGTTACCACACACTTACAACAGAACTAG|ACAGAACCTCAGGAACCGAGACGCTTGAAC
ACGTTACCACACACTTACAACAGAACGGTA|TAGGTGTTTCAGGTTCTGGGGATCCCGGCA
GAACGTTACCACACACTTACAACAGAACTC|CACTTATGTGCCCTTGTTTCACGGTGACGG
CACACTTACAACAGAACACTTATGTGCCCT|GGTAGGGAGAGTTGAACGTTACCACACACT
GATTTGAACGTTACCACACACTTACAACAG|GTGGTGAGAAAACTCTGGTTTATCTCAGAT
ACGTTACCACACACTTACAACAGAACTACA|CACGACTGGTCGAACGTAACATTTCGAGTA
CCGCACGCTCAGACTGAGACGCTTGGTAAG|CCTGGTTCAGAAGATCTAGCTTGAACGTTA
CCGGGAGTCTCAAGAGCGCAGAGGACCAAC|ACTTACAACAGAACTGTGGTTCGAACTAAA
GTCCTGCCCGAGCACGAGTTAACCAGATAT|AGGACTCGAACTCTCTTAAGAGAACTGAAT
AGAACGGTAACGCTTGTCTCGCTGGGCGCA|ATCCCGGCATAAACGGGAGAGCATGCTGAC
GATACATAGGGCCCAATGTGCATGGCGTTG|TTGAACGTTACCACACACTTACAACAGAAC
ACCAGGCTATTGTTGAACGTTACCACACAC|AACCTGCATGAAAAGCGTTGGAACGGGTAG
CTTACAACAGAACTGGCCTTGTCCTCATGC|ACACTTACAACAGAACTCGGTCATAATAAG
GACGCTTGAACGTTACCACACACTTACAAC|ACTTACAACAGAACTGGCCTTGTCCTCATG
GGGTTCCTTCACAGAATTGAACGTTACCAC|ACGATAACGATCCTTAGACAGGGTCGTCCG
AGTGAGCCACCATGATTCTTCTACAGTGAT|ATCGAATAAGTACTACAGGTTTCAACGGTG
GTTAACTTTATCTAATGTACCTAGAACCTT|CCAGTGAGCCACCATGATTCTTCTACAGTG
TCTATTGAACGTTACCACACACTTACAACA|GGGGTTCCTTCACAGAATTGAACGTTACCA
CACACACTTACAACAGAACACTTATGTGCC|CGGGTAGGGAGAGTTGAACGTTACCACACA
TTACCACACACTTACAACAGAACGCCACGC|CCCAATGTGCATGGCGTTGAACGTTACCAC
TACAATAAGCTTGAACGTTACCACACACTT|CAGAACGGGATCCGTCCTGCCCGAGCACGA
AAGAGCGCAGAGGACCAACCAGGCTATTGT|AACTGTGGTTCGAACTAAACCTGCATGAAA
TTGAACGTTACCACACACTTACAACAGAAC|GTGAGAAAACTCTGGTTTATCTCAGATACG
CAGAACGCCACGCGCGCGGTAGTTTCCTCC|TGAACGTTACCACACACTTACAACAGAACT
CTCTATTGAACGTTACCACACACTTACAAC|CGGGGTTCCTTCACAGAATTGAACGTTACC
GTAACATTTCGAGTAACGTTGAACGTTACC|TTGTCGCGATCTACAATAAGCTTGAACGTT
ACCGAGACGCTTGAACGTTACCACACACTT|CACACACTTACAACAGAACTGGCCTTGTCC
CACACTTACAACAGAACCATGTTGAACGTT|TTGTTCGGAGGACCCGATCAGAGAAGAAGG
AAGAAGGAACTTTATGGTAAACACGACTGG|ATCTAATGTACCTAGAACCTTCCGTCGGGG
CAATAAGCTTGAACGTTACCACACACTTAC|GAACGGGATCCGTCCTGCCCGAGCACGAGT
TTGAACGTTACCACACACTTACAACAGAAC|GACAGGGTCGTCCGAAGCTGATGGGCCAAA
CGTTACCACACACTTACAACAGAACTAGTC|AGAACCTCAGGAACCGAGACGCTTGAACGT
AATAAGTCCAGACGACTGATAAGTGGCCAG|GCAAACGATGCACATTCTAATAAGGCTCAT
TGTGAATTCTAGCGCACCGACATCCAGGCT|CAAGAGCGCAGAGGACCAACCAGGCTATTG
CATGATTCTTCTACAGTGATTTGAACGTTA|TACTACAGGTTTCAACGGTGGTGAGAAAAC
CTGTGGTTCGAACTAAACCTGCATGAAAAG|ATTTCCCGTTATCAGTGGATAGCACCACCG
CACACACTTACAACAGAACAGCGACGATAA|GGTAACGCTTGTCTCGCTGGGCGCACCACC
ATGGGCCAAATTTCCCGTTATCAGTGGATA|TGGTAAGTCGCGGCTTACCCATCGTCCTAG
CCGGTTTGAACGTTACCACACACTTACAAC|CAAATTGAATAGGTGTTTCAGGTTCTGGGG
CACTTACAACAGAACAGCGACGATAACGAT|ACGCTTGTCTCGCTGGGCGCACCACCGACT
ACTAAACCTGCATGAAAAGCGTTGGAACGG|TCAGTGGATAGCACCACCGGTTTGAACGTT
GCGATCTACAATAAGCTTGAACGTTACCAC|TTACAACAGAACGGGATCCGTCCTGCCCGA
ACGCGCGCGGTAGTTTCCTCCCATTGGCAG|CCACACACTTACAACAGAACTCTATTGAAC
AGAACACTTATGTGCCCTTGTTTCACGGTG|TGAACGTTACCACACACTTACAACAGAACA
ACCACACACTTACAACAGAACTAGTCCACA|CCTCAGGAACCGAGACGCTTGAACGTTACC
GAACGTTACCACACACTTACAACAGAACTA|AACACGACTGGTCGAACGTAACATTTCGAG
TAACATTGCTGTGAATTCTAGCGCACCGAC|CGGGAGTCTCAAGAGCGCAGAGGACCAACC
GTTCGGAGGACCCGATCAGAGAAGAAGGAA|GCAGGTCCAATAGTTAACTTTATCTAATGT
GGTTCGTACACCACTTAACATTGCTGTGAA|CACTTACAACAGAACCGGGAGTCTCAAGAG
ACAGAACGGTAACGCTTGTCTCGCTGGGCG|GGATCCCGGCATAAACGGGAGAGCATGCTG
CGGTAGTTTCCTCCCATTGGCAGTGAAGGC|CTTACAACAGAACTCTATTGAACGTTACCA
GCAGTGAAGGCACGGTTCGTACACCACTTA|GAACGTTACCACACACTTACAACAGAACCG
ACACACTTACAACAGAACTCTATTGAACGT|CCCTTGTTTCACGGTGACGGGGTTCCTTCA
GATTCTTCTACAGTGATTTGAACGTTACCA|TACAGGTTTCAACGGTGGTGAGAAAACTCT
GAACTGTGGTTCGAACTAAACCTGCATGAA|CAAATTTCCCGTTATCAGTGGATAGCACCA
ACGATCCTTAGACAGGGTCGTCCGAAGCTG|CGACTCACCGCACGCTCAGACTGAGACGCT
TTATGGTAAACACGACTGGTCGAACGTAAC|CTAGAACCTTCCGTCGGGGAACTCCTTGTC
GGGCGTCCACCCTGGTTCAGAAGATCTAGC|TGAACGTTACCACACACTTACAACAGAACT
AGAACTCGGTCATAATAAGTCCAGACGACT|CCAGATATCTTTCGCAAACGATGCACATTC
ACGCTCAGACTGAGACGCTTGGTAAGTCGC|GTTCAGAAGATCTAGCTTGAACGTTACCAC
TTACCACACACTTACAACAGAACAGCGACG|GAACGGTAACGCTTGTCTCGCTGGGCGCAC
CAGAACTCGGTCATAATAAGTCCAGACGAC|ACCAGATATCTTTCGCAAACGATGCACATT
TCTATGCAGGTCCAATAGTTAACTTTATCT|AGACGACTGATAAGTGGCCAGTGAGCCACC
AACAGAACGCCACGCGCGCGGTAGTTTCCT|GTTGAACGTTACCACACACTTACAACAGAA
GGTTCCTTCACAGAATTGAACGTTACCACA|CGATAACGATCCTTAGACAGGGTCGTCCGA
TGAATTCTAGCGCACCGACATCCAGGCTGA|AGAGCGCAGAGGACCAACCAGGCTATTGTT
GCTGGGCGCACCACCGACTCACCGCACGCT|GCATGCTGACCGGGCGTCCACCCTGGTTCA
TATCTAATGTACCTAGAACCTTCCGTCGGG|CCACCATGATTCTTCTACAGTGATTTGAAC
GATAGCACCACCGGTTTGAACGTTACCACA|CTAGTGCGCCCAAATTGAATAGGTGTTTCA
TGGGCGCACCACCGACTCACCGCACGCTCA|ATGCTGACCGGGCGTCCACCCTGGTTCAGA
AAGCTTGAACGTTACCACACACTTACAACA|GGGATCCGTCCTGCCCGAGCACGAGTTAAC
ACGTTACCACACACTTACAACAGAACAGCG|ACAGAACGGTAACGCTTGTCTCGCTGGGCG
TTGAACGTTACCACACACTTACAACAGAAC|TTCCTTCACAGAATTGAACGTTACCACACA
CGCCCAAATTGAATAGGTGTTTCAGGTTCT|CACACCAGCGTTTGAACGTTACCACACACT
TATGGTAAACACGACTGGTCGAACGTAACA|TAGAACCTTCCGTCGGGGAACTCCTTGTCG
AGCACGAGTTAACCAGATATCTTTCGCAAA|CTCTCTTAAGAGAACTGAATGTAACTCCAA
ACACACTTTGAACGTTACCACACACTTACA|TTTATGGTAAACACGACTGGTCGAACGTAA
TAACGTTGAACGTTACCACACACTTACAAC|CAATAAGCTTGAACGTTACCACACACTTAC
ACAGAACAGCGACGATAACGATCCTTAGAC|CTCGCTGGGCGCACCACCGACTCACCGCAC
ACCGGTTTGAACGTTACCACACACTTACAA|CCAAATTGAATAGGTGTTTCAGGTTCTGGG
ATTGGCAGTGAAGGCACGGTTCGTACACCA|TATTGAACGTTACCACACACTTACAACAGA
GGAACTCCTTGTCGCGATCTACAATAAGCT|CGTTACCACACACTTACAACAGAACGGGAT
ACACACTTACAACAGAACTCGGTCATAATA|GAGCACGAGTTAACCAGATATCTTTCGCAA
GACCAACCAGGCTATTGTTGAACGTTACCA|AACTAAACCTGCATGAAAAGCGTTGGAACG
TTACAACAGAACGGTAACGCTTGTCTCGCT|TCTGGGGATCCCGGCATAAACGGGAGAGCA
AACGGTAACGCTTGTCTCGCTGGGCGCACC|CCCGGCATAAACGGGAGAGCATGCTGACCG
GCTGATACATAGGGCCCAATGTGCATGGCG|TTGTTGAACGTTACCACACACTTACAACAG
ACGGGATCCGTCCTGCCCGAGCACGAGTTA|CGGAGGTGAAGGACTCGAACTCTCTTAAGA
ATAACGATCCTTAGACAGGGTCGTCCGAAG|CACCGACTCACCGCACGCTCAGACTGAGAC
GCTCATCTATGCAGGTCCAATAGTTAACTT|AGTCCAGACGACTGATAAGTGGCCAGTGAG
CAGAACTGTGGTTCGAACTAAACCTGCATG|GCCAAATTTCCCGTTATCAGTGGATAGCAC
GCAGGGTCTTGAACGTTACCACACACTTAC|GGCTGATACATAGGGCCCAATGTGCATGGC
AGTGGCCAGTGAGCCACCATGATTCTTCTA|AAGGCTCATCGAATAAGTACTACAGGTTTC
GCCCTTGTTTCACGGTGACGGGGTTCCTTC|ACACTTACAACAGAACAGCGACGATAACGA
GCGTTTGAACGTTACCACACACTTACAACA|CACTTACAACAGAACGCTTGTTCGGAGGAC
AACAGAACTGTGGTTCGAACTAAACCTGCA|GGGCCAAATTTCCCGTTATCAGTGGATAGC
CGCTTGAACGTTACCACACACTTACAACAG|TTACAACAGAACTGGCCTTGTCCTCATGCT
CTGCCCGAGCACGAGTTAACCAGATATCTT|ACTCGAACTCTCTTAAGAGAACTGAATGTA
AAGATCTAGCTTGAACGTTACCACACACTT|CAACAGAACTACAACAGAACCTCAGGAACC
ATAGGGCCCAATGTGCATGGCGTTGAACGT|CGTTACCACACACTTACAACAGAACACTTA
CCCATCGTCCTAGTGCGCCCAAATTGAATA|ACAACAGAACTAGTCCACACCAGCGTTTGA
ACTTACAACAGAACTCGGTCATAATAAGTC|ACGAGTTAACCAGATATCTTTCGCAAACGA
ATTCTAGCGCACCGACATCCAGGCTGATAC|GCGCAGAGGACCAACCAGGCTATTGTTGAA
ACTCACCGCACGCTCAGACTGAGACGCTTG|TCCACCCTGGTTCAGAAGATCTAGCTTGAA
ATAATAAGTCCAGACGACTGATAAGTGGCC|TCGCAAACGATGCACATTCTAATAAGGCTC
AACGTTACCACACACTTACAACAGAACTGT|AGGGTCGTCCGAAGCTGATGGGCCAAATTT
TTACAACAGAACTGTGGTTCGAACTAAACC|TGATGGGCCAAATTTCCCGTTATCAGTGGA
TTCAGGTTCTGGGGATCCCGGCATAAACGG|ACCACACACTTACAACAGAACCATGTTGAA
GTTACCACACACTTACAACAGAACCGGGAG|CACAGAATTGAACGTTACCACACACTTACA
CTAGCTTGAACGTTACCACACACTTACAAC|GAACTACAACAGAACCTCAGGAACCGAGAC
ACGTTACCACACACTTACAACAGAACGGGA|GAAAACTCTGGTTTATCTCAGATACGGAGG
CCTCCCATTGGCAGTGAAGGCACGGTTCGT|GAACTCTATTGAACGTTACCACACACTTAC
CAGAACTCTATTGAACGTTACCACACACTT|GGTGACGGGGTTCCTTCACAGAATTGAACG
GCCACGCGCGCGGTAGTTTCCTCCCATTGG|TTACCACACACTTACAACAGAACTCTATTG
GAACGGTAACGCTTGTCTCGCTGGGCGCAC|TCCCGGCATAAACGGGAGAGCATGCTGACC
TCAAGAGCGCAGAGGACCAACCAGGCTATT|AGAACTGTGGTTCGAACTAAACCTGCATGA
ACAGAACTACAACAGAACCTCAGGAACCGA|CATTTCGAGTAACGTTGAACGTTACCACAC
AACAGAACTAGTCCACACCAGCGTTTGAAC|GACGCTTGAACGTTACCACACACTTACAAC
CAACCAGGCTATTGTTGAACGTTACCACAC|TAAACCTGCATGAAAAGCGTTGGAACGGGT
TCAGGTTCTGGGGATCCCGGCATAAACGGG|CCACACACTTACAACAGAACCATGTTGAAC
CACACTTACAACAGAACGCCACGCGCGCGG|GTGCATGGCGTTGAACGTTACCACACACTT
GGCCAGTGAGCCACCATGATTCTTCTACAG|GCTCATCGAATAAGTACTACAGGTTTCAAC
TAACATTTCGAGTAACGTTGAACGTTACCA|TGTCGCGATCTACAATAAGCTTGAACGTTA
CACAGAATTGAACGTTACCACACACTTACA|ATCCTTAGACAGGGTCGTCCGAAGCTGATG
ACATAGGGCCCAATGTGCATGGCGTTGAAC|AACGTTACCACACACTTACAACAGAACACT
AACTTTATGGTAAACACGACTGGTCGAACG|GTACCTAGAACCTTCCGTCGGGGAACTCCT
CCACACACTTACAACAGAACTCTATTGAAC|TGCCCTTGTTTCACGGTGACGGGGTTCCTT
GATCCTTAGACAGGGTCGTCCGAAGCTGAT|ACTCACCGCACGCTCAGACTGAGACGCTTG
TCAGACTGAGACGCTTGGTAAGTCGCGGCT|AGAAGATCTAGCTTGAACGTTACCACACAC
CTGGGGATCCCGGCATAAACGGGAGAGCAT|CTTACAACAGAACCATGTTGAACGTTACCA
TACAGTGATTTGAACGTTACCACACACTTA|TCAACGGTGGTGAGAAAACTCTGGTTTATC
AAAGCGTTGGAACGGGTAGGGAGAGTTGAA|ACCGGTTTGAACGTTACCACACACTTACAA
AACAGAACTCGGTCATAATAAGTCCAGACG|TAACCAGATATCTTTCGCAAACGATGCACA
TCCTCATGCTCATCTATGCAGGTCCAATAG|CATAATAAGTCCAGACGACTGATAAGTGGC
CGGTCATAATAAGTCCAGACGACTGATAAG|ATCTTTCGCAAACGATGCACATTCTAATAA
GCTTACCCATCGTCCTAGTGCGCCCAAATT|CACTTACAACAGAACTAGTCCACACCAGCG
ACAGAACGCTTGTTCGGAGGACCCGATCAG|TGCTCATCTATGCAGGTCCAATAGTTAACT
AGTTTCCTCCCATTGGCAGTGAAGGCACGG|CAACAGAACTCTATTGAACGTTACCACACA
ACAGAACGCCACGCGCGCGGTAGTTTCCTC|TTGAACGTTACCACACACTTACAACAGAAC
ACAACAGAACCTCAGGAACCGAGACGCTTG|GTAACGTTGAACGTTACCACACACTTACAA
TGGAACGGGTAGGGAGAGTTGAACGTTACC|TGAACGTTACCACACACTTACAACAGAACG
TCGCGATCTACAATAAGCTTGAACGTTACC|ACTTACAACAGAACGGGATCCGTCCTGCCC
TACAACAGAACGGGATCCGTCCTGCCCGAG|TCTCAGATACGGAGGTGAAGGACTCGAACT
CGGGCGTCCACCCTGGTTCAGAAGATCTAG|TTGAACGTTACCACACACTTACAACAGAAC
CGAGACGCTTGAACGTTACCACACACTTAC|CACACTTACAACAGAACTGGCCTTGTCCTC
CGTCCACCCTGGTTCAGAAGATCTAGCTTG|ACGTTACCACACACTTACAACAGAACTACA
TTGAACGTTACCACACACTTACAACAGAAC|ACAACAGAACCTCAGGAACCGAGACGCTTG
CACTTACAACAGAACCATGTTGAACGTTAC|GTTCGGAGGACCCGATCAGAGAAGAAGGAA
CACACTTACAACAGAACTGGCCTTGTCCTC|CCACACACTTACAACAGAACTCGGTCATAA
TTTGAACGTTACCACACACTTACAACAGAA|GGTGAGAAAACTCTGGTTTATCTCAGATAC
TTCTACAGTGATTTGAACGTTACCACACAC|GTTTCAACGGTGGTGAGAAAACTCTGGTTT
CAGAACAGCGACGATAACGATCCTTAGACA|TCGCTGGGCGCACCACCGACTCACCGCACG
CCGTCCTGCCCGAGCACGAGTTAACCAGAT|GAAGGACTCGAACTCTCTTAAGAGAACTGA
ACGGGAGAGCATGCTGACCGGGCGTCCACC|TGAACGTTACCACACACTTTGAACGTTACC
CACACTTACAACAGAACCGGGAGTCTCAAG|TTGAACGTTACCACACACTTACAACAGAAC
TACCACACACTTTGAACGTTACCACACACT|GAACTTTATGGTAAACACGACTGGTCGAAC
TTACCACACACTTTGAACGTTACCACACAC|GGAACTTTATGGTAAACACGACTGGTCGAA
TTACCACACACTTACAACAGAACCGGGAGT|ACAGAATTGAACGTTACCACACACTTACAA
TTATCTAATGTACCTAGAACCTTCCGTCGG|GCCACCATGATTCTTCTACAGTGATTTGAA
ACTTACAACAGAACCGGGAGTCTCAAGAGC|AACGTTACCACACACTTACAACAGAACTGT
ACAGAATTGAACGTTACCACACACTTACAA|TCCTTAGACAGGGTCGTCCGAAGCTGATGG
TAACGCTTGTCTCGCTGGGCGCACCACCGA|CATAAACGGGAGAGCATGCTGACCGGGCGT
AGAACCTTCCGTCGGGGAACTCCTTGTCGC|CTACAGTGATTTGAACGTTACCACACACTT
CAACAGAACACTTATGTGCCCTTGTTTCAC|GAGTTGAACGTTACCACACACTTACAACAG
TCTAGCGCACCGACATCCAGGCTGATACAT|GCAGAGGACCAACCAGGCTATTGTTGAACG
CCATTGGCAGTGAAGGCACGGTTCGTACAC|TCTATTGAACGTTACCACACACTTACAACA
TGATACATAGGGCCCAATGTGCATGGCGTT|GTTGAACGTTACCACACACTTACAACAGAA
CTAGCGCACCGACATCCAGGCTGATACATA|CAGAGGACCAACCAGGCTATTGTTGAACGT
CAGGTCCAATAGTTAACTTTATCTAATGTA|CTGATAAGTGGCCAGTGAGCCACCATGATT
ACCAGCGTTTGAACGTTACCACACACTTAC|CACACACTTACAACAGAACGCTTGTTCGGA
ACACTTACAACAGAACTCGGTCATAATAAG|GCACGAGTTAACCAGATATCTTTCGCAAAC
AACGCTTGTCTCGCTGGGCGCACCACCGAC|ATAAACGGGAGAGCATGCTGACCGGGCGTC
CATAGGGCCCAATGTGCATGGCGTTGAACG|ACGTTACCACACACTTACAACAGAACACTT
TAGGGCCCAATGTGCATGGCGTTGAACGTT|GTTACCACACACTTACAACAGAACACTTAT
GAACTCCTTGTCGCGATCTACAATAAGCTT|GTTACCACACACTTACAACAGAACGGGATC
TGAACGTTACCACACACTTACAACAGAACT|CCGTCCTGCCCGAGCACGAGTTAACCAGAT
GCTTGTCTCGCTGGGCGCACCACCGACTCA|AACGGGAGAGCATGCTGACCGGGCGTCCAC
TCCACCCTGGTTCAGAAGATCTAGCTTGAA|GTTACCACACACTTACAACAGAACTACAAC
ACACTTACAACAGAACCGGGAGTCTCAAGA|TGAACGTTACCACACACTTACAACAGAACT
ACACTTACAACAGAACGCTTGTTCGGAGGA|TTGTCCTCATGCTCATCTATGCAGGTCCAA
GTTTGAACGTTACCACACACTTACAACAGA|CTTACAACAGAACGCTTGTTCGGAGGACCC
AGAACGCCACGCGCGCGGTAGTTTCCTCCC|GAACGTTACCACACACTTACAACAGAACTC
TCATAATAAGTCCAGACGACTGATAAGTGG|TTTCGCAAACGATGCACATTCTAATAAGGC
TTACAACAGAACTCGGTCATAATAAGTCCA|GAGTTAACCAGATATCTTTCGCAAACGATG
ACAGAACCGGGAGTCTCAAGAGCGCAGAGG|CCACACACTTACAACAGAACTGTGGTTCGA
AGTTGAACGTTACCACACACTTACAACAGA|CTTACAACAGAACGGTAACGCTTGTCTCGC
GCATAAACGGGAGAGCATGCTGACCGGGCG|CCATGTTGAACGTTACCACACACTTTGAAC
ACCACACACTTACAACAGAACCGGGAGTCT|AGAATTGAACGTTACCACACACTTACAACA
GTAAACACGACTGGTCGAACGTAACATTTC|ACCTTCCGTCGGGGAACTCCTTGTCGCGAT
CAGCGTTTGAACGTTACCACACACTTACAA|CACACTTACAACAGAACGCTTGTTCGGAGG
TTGGTAAGTCGCGGCTTACCCATCGTCCTA|GAACGTTACCACACACTTACAACAGAACTA
AACCGGGAGTCTCAAGAGCGCAGAGGACCA|ACACTTACAACAGAACTGTGGTTCGAACTA
AACGTTGAACGTTACCACACACTTACAACA|AATAAGCTTGAACGTTACCACACACTTACA
GCACGGTTCGTACACCACTTAACATTGCTG|CACACACTTACAACAGAACCGGGAGTCTCA
CCCTGGTTCAGAAGATCTAGCTTGAACGTT|CCACACACTTACAACAGAACTACAACAGAA
TTACCACACACTTACAACAGAACTGTGGTT|TCGTCCGAAGCTGATGGGCCAAATTTCCCG
AGAGTTGAACGTTACCACACACTTACAACA|CACTTACAACAGAACGGTAACGCTTGTCTC
GTCTCAAGAGCGCAGAGGACCAACCAGGCT|AACAGAACTGTGGTTCGAACTAAACCTGCA
TACCACACACTTACAACAGAACGGGATCCG|ACTCTGGTTTATCTCAGATACGGAGGTGAA
CAACAGAACGGGATCCGTCCTGCCCGAGCA|TCAGATACGGAGGTGAAGGACTCGAACTCT
CCAGTGAGCCACCATGATTCTTCTACAGTG|TCATCGAATAAGTACTACAGGTTTCAACGG
ACCACACACTTTGAACGTTACCACACACTT|AACTTTATGGTAAACACGACTGGTCGAACG
GAGAAGAAGGAACTTTATGGTAAACACGAC|TTTATCTAATGTACCTAGAACCTTCCGTCG
CAAATTGAATAGGTGTTTCAGGTTCTGGGG|CCAGCGTTTGAACGTTACCACACACTTACA
GAACTCGGTCATAATAAGTCCAGACGACTG|CAGATATCTTTCGCAAACGATGCACATTCT
CACGGTTCGTACACCACTTAACATTGCTGT|ACACACTTACAACAGAACCGGGAGTCTCAA
CGTCCGAAGCTGATGGGCCAAATTTCCCGT|GACTGAGACGCTTGGTAAGTCGCGGCTTAC
ATAAGCTTGAACGTTACCACACACTTACAA|ACGGGATCCGTCCTGCCCGAGCACGAGTTA
ACGACTGATAAGTGGCCAGTGAGCCACCAT|ACATTCTAATAAGGCTCATCGAATAAGTAC
GTTACCACACACTTACAACAGAACAGCGAC|AGAACGGTAACGCTTGTCTCGCTGGGCGCA
CGATAACGATCCTTAGACAGGGTCGTCCGA|ACCACCGACTCACCGCACGCTCAGACTGAG
ATAGGTGTTTCAGGTTCTGGGGATCCCGGC|TGAACGTTACCACACACTTACAACAGAACC
GGTCGAACGTAACATTTCGAGTAACGTTGA|GGAACTCCTTGTCGCGATCTACAATAAGCT
ACACACTTACAACAGAACGGTAACGCTTGT|TCAGGTTCTGGGGATCCCGGCATAAACGGG
AGGGTCTTGAACGTTACCACACACTTACAA|CTGATACATAGGGCCCAATGTGCATGGCGT
AACCAGGCTATTGTTGAACGTTACCACACA|AAACCTGCATGAAAAGCGTTGGAACGGGTA
ACTCGGTCATAATAAGTCCAGACGACTGAT|GATATCTTTCGCAAACGATGCACATTCTAA
GTAAGTCGCGGCTTACCCATCGTCCTAGTG|CGTTACCACACACTTACAACAGAACTAGTC
GAACGTTACCACACACTTACAACAGAACTC|CGTCCTGCCCGAGCACGAGTTAACCAGATA
AGCGTTTGAACGTTACCACACACTTACAAC|ACACTTACAACAGAACGCTTGTTCGGAGGA
ACACTTACAACAGAACCATGTTGAACGTTA|TGTTCGGAGGACCCGATCAGAGAAGAAGGA
TAGCGCACCGACATCCAGGCTGATACATAG|AGAGGACCAACCAGGCTATTGTTGAACGTT
GGCGCACCACCGACTCACCGCACGCTCAGA|GCTGACCGGGCGTCCACCCTGGTTCAGAAG
TACCACACACTTACAACAGAACTCTATTGA|TGTGCCCTTGTTTCACGGTGACGGGGTTCC
TTACAACAGAACCGGGAGTCTCAAGAGCGC|CGTTACCACACACTTACAACAGAACTGTGG
ACAACAGAACGCCACGCGCGCGGTAGTTTC|GCGTTGAACGTTACCACACACTTACAACAG
TAGCTTGAACGTTACCACACACTTACAACA|AACTACAACAGAACCTCAGGAACCGAGACG
AAGCTGATGGGCCAAATTTCCCGTTATCAG|GACGCTTGGTAAGTCGCGGCTTACCCATCG
GAGTAACGTTGAACGTTACCACACACTTAC|CTACAATAAGCTTGAACGTTACCACACACT
AGAAGAAGGAACTTTATGGTAAACACGACT|TTATCTAATGTACCTAGAACCTTCCGTCGG
GTTACCACACACTTACAACAGAACGCCACG|GCCCAATGTGCATGGCGTTGAACGTTACCA
CTTTATCTAATGTACCTAGAACCTTCCGTC|GAGCCACCATGATTCTTCTACAGTGATTTG
CAGGCTGATACATAGGGCCCAATGTGCATG|CTATTGTTGAACGTTACCACACACTTACAA
AACGTTACCACACACTTACAACAGAACGCT|CAGAACTGGCCTTGTCCTCATGCTCATCTA
GGCTGATACATAGGGCCCAATGTGCATGGC|ATTGTTGAACGTTACCACACACTTACAACA
GGTGTTTCAGGTTCTGGGGATCCCGGCATA|ACGTTACCACACACTTACAACAGAACCATG
TCCTAGTGCGCCCAAATTGAATAGGTGTTT|AACTAGTCCACACCAGCGTTTGAACGTTAC
GTCGCGGCTTACCCATCGTCCTAGTGCGCC|ACCACACACTTACAACAGAACTAGTCCACA
GTGTTTCAGGTTCTGGGGATCCCGGCATAA|CGTTACCACACACTTACAACAGAACCATGT
ACCGCACGCTCAGACTGAGACGCTTGGTAA|CCCTGGTTCAGAAGATCTAGCTTGAACGTT
GTCCAATAGTTAACTTTATCTAATGTACCT|ATAAGTGGCCAGTGAGCCACCATGATTCTT
GATCTAGCTTGAACGTTACCACACACTTAC|ACAGAACTACAACAGAACCTCAGGAACCGA
CCTAGTGCGCCCAAATTGAATAGGTGTTTC|ACTAGTCCACACCAGCGTTTGAACGTTACC
CACTTACAACAGAACGCTTGTTCGGAGGAC|TGTCCTCATGCTCATCTATGCAGGTCCAAT
GAACGTTACCACACACTTACAACAGAACAG|CAACAGAACGGTAACGCTTGTCTCGCTGGG
TTCACAGAATTGAACGTTACCACACACTTA|CGATCCTTAGACAGGGTCGTCCGAAGCTGA
AGGAACCGAGACGCTTGAACGTTACCACAC|TTACCACACACTTACAACAGAACTGGCCTT
AGGCTATTGTTGAACGTTACCACACACTTA|CTGCATGAAAAGCGTTGGAACGGGTAGGGA
CCGAGACGCTTGAACGTTACCACACACTTA|ACACACTTACAACAGAACTGGCCTTGTCCT
GCGCGGTAGTTTCCTCCCATTGGCAGTGAA|ACACTTACAACAGAACTCTATTGAACGTTA
CCATCGTCCTAGTGCGCCCAAATTGAATAG|CAACAGAACTAGTCCACACCAGCGTTTGAA
GGTAAGTCGCGGCTTACCCATCGTCCTAGT|ACGTTACCACACACTTACAACAGAACTAGT
TACCCATCGTCCTAGTGCGCCCAAATTGAA|TTACAACAGAACTAGTCCACACCAGCGTTT
AACCGAGACGCTTGAACGTTACCACACACT|CCACACACTTACAACAGAACTGGCCTTGTC
CAACAGAACCATGTTGAACGTTACCACACA|AGGACCCGATCAGAGAAGAAGGAACTTTAT
CGTTTGAACGTTACCACACACTTACAACAG|ACTTACAACAGAACGCTTGTTCGGAGGACC
GTTACCACACACTTACAACAGAACTCGGTC|CTGCCCGAGCACGAGTTAACCAGATATCTT
AAGCGTTGGAACGGGTAGGGAGAGTTGAAC|CCGGTTTGAACGTTACCACACACTTACAAC
TCCGTCGGGGAACTCCTTGTCGCGATCTAC|GATTTGAACGTTACCACACACTTACAACAG
CAGAGGACCAACCAGGCTATTGTTGAACGT|GTTCGAACTAAACCTGCATGAAAAGCGTTG
CAGTGATTTGAACGTTACCACACACTTACA|AACGGTGGTGAGAAAACTCTGGTTTATCTC
CACACACTTACAACAGAACTGTGGTTCGAA|CCGAAGCTGATGGGCCAAATTTCCCGTTAT
GCATGGCGTTGAACGTTACCACACACTTAC|TACAACAGAACACTTATGTGCCCTTGTTTC
TACCACACACTTACAACAGAACTAGTCCAC|ACCTCAGGAACCGAGACGCTTGAACGTTAC
ACACACTTACAACAGAACTGGCCTTGTCCT|ACCACACACTTACAACAGAACTCGGTCATA
CTATTGTTGAACGTTACCACACACTTACAA|CATGAAAAGCGTTGGAACGGGTAGGGAGAG
AACGTTACCACACACTTTGAACGTTACCAC|AGAAGGAACTTTATGGTAAACACGACTGGT
GGATCCCGGCATAAACGGGAGAGCATGCTG|CAACAGAACCATGTTGAACGTTACCACACA
ACAACAGAACGGGATCCGTCCTGCCCGAGC|CTCAGATACGGAGGTGAAGGACTCGAACTC
ACTTAACATTGCTGTGAATTCTAGCGCACC|AACCGGGAGTCTCAAGAGCGCAGAGGACCA
ACCACACACTTACAACAGAACTGTGGTTCG|GTCCGAAGCTGATGGGCCAAATTTCCCGTT
AGGTTCTGGGGATCCCGGCATAAACGGGAG|ACACACTTACAACAGAACCATGTTGAACGT
ACGCTTGAACGTTACCACACACTTACAACA|CTTACAACAGAACTGGCCTTGTCCTCATGC
GAACGCCACGCGCGCGGTAGTTTCCTCCCA|AACGTTACCACACACTTACAACAGAACTCT
GAGACGCTTGGTAAGTCGCGGCTTACCCAT|CTAGCTTGAACGTTACCACACACTTACAAC
TTTCACGGTGACGGGGTTCCTTCACAGAAT|CAACAGAACAGCGACGATAACGATCCTTAG
GAACTTTATGGTAAACACGACTGGTCGAAC|TGTACCTAGAACCTTCCGTCGGGGAACTCC
TCCGAAGCTGATGGGCCAAATTTCCCGTTA|CTGAGACGCTTGGTAAGTCGCGGCTTACCC
GCCCAATGTGCATGGCGTTGAACGTTACCA|CCACACACTTACAACAGAACACTTATGTGC
TACAACAGAACCGGGAGTCTCAAGAGCGCA|GTTACCACACACTTACAACAGAACTGTGGT
GTGCCCTTGTTTCACGGTGACGGGGTTCCT|ACACACTTACAACAGAACAGCGACGATAAC
CAGTGGATAGCACCACCGGTTTGAACGTTA|TCGTCCTAGTGCGCCCAAATTGAATAGGTG
TACAACAGAACACTTATGTGCCCTTGTTTC|GAGAGTTGAACGTTACCACACACTTACAAC
GAGAGTTGAACGTTACCACACACTTACAAC|ACACTTACAACAGAACGGTAACGCTTGTCT
GTCCGAAGCTGATGGGCCAAATTTCCCGTT|ACTGAGACGCTTGGTAAGTCGCGGCTTACC
CGATCCTTAGACAGGGTCGTCCGAAGCTGA|GACTCACCGCACGCTCAGACTGAGACGCTT
TAGTGCGCCCAAATTGAATAGGTGTTTCAG|TAGTCCACACCAGCGTTTGAACGTTACCAC
TTAACTTTATCTAATGTACCTAGAACCTTC|CAGTGAGCCACCATGATTCTTCTACAGTGA
ACTTACAACAGAACTGTGGTTCGAACTAAA|GCTGATGGGCCAAATTTCCCGTTATCAGTG
TCCCGGCATAAACGGGAGAGCATGCTGACC|CAGAACCATGTTGAACGTTACCACACACTT
TTCAGAAGATCTAGCTTGAACGTTACCACA|ACTTACAACAGAACTACAACAGAACCTCAG
CGACTGATAAGTGGCCAGTGAGCCACCATG|CATTCTAATAAGGCTCATCGAATAAGTACT
TGATGGGCCAAATTTCCCGTTATCAGTGGA|CTTGGTAAGTCGCGGCTTACCCATCGTCCT
CGTTACCACACACTTACAACAGAACTCGGT|CCTGCCCGAGCACGAGTTAACCAGATATCT
GCACCACCGACTCACCGCACGCTCAGACTG|GACCGGGCGTCCACCCTGGTTCAGAAGATC
ACGTTACCACACACTTTGAACGTTACCACA|GAAGGAACTTTATGGTAAACACGACTGGTC
GCACGCTCAGACTGAGACGCTTGGTAAGTC|TGGTTCAGAAGATCTAGCTTGAACGTTACC
CGCTTGGTAAGTCGCGGCTTACCCATCGTC|CTTGAACGTTACCACACACTTACAACAGAA
GAGAGCATGCTGACCGGGCGTCCACCCTGG|CGTTACCACACACTTTGAACGTTACCACAC
TAGCACCACCGGTTTGAACGTTACCACACA|AGTGCGCCCAAATTGAATAGGTGTTTCAGG
CTAGTGCGCCCAAATTGAATAGGTGTTTCA|CTAGTCCACACCAGCGTTTGAACGTTACCA
AAAAGCGTTGGAACGGGTAGGGAGAGTTGA|CACCGGTTTGAACGTTACCACACACTTACA
CGTTACCACACACTTACAACAGAACGCCAC|GGCCCAATGTGCATGGCGTTGAACGTTACC
TCAGTGGATAGCACCACCGGTTTGAACGTT|ATCGTCCTAGTGCGCCCAAATTGAATAGGT
CCGTCGGGGAACTCCTTGTCGCGATCTACA|ATTTGAACGTTACCACACACTTACAACAGA
TACAACAGAACTCTATTGAACGTTACCACA|TTCACGGTGACGGGGTTCCTTCACAGAATT
CTTGTCGCGATCTACAATAAGCTTGAACGT|ACACACTTACAACAGAACGGGATCCGTCCT
GGGTCGTCCGAAGCTGATGGGCCAAATTTC|CTCAGACTGAGACGCTTGGTAAGTCGCGGC
ACTGTGGTTCGAACTAAACCTGCATGAAAA|AATTTCCCGTTATCAGTGGATAGCACCACC
CACACACTTACAACAGAACGCCACGCGCGC|ATGTGCATGGCGTTGAACGTTACCACACAC
CCACACCAGCGTTTGAACGTTACCACACAC|TTACCACACACTTACAACAGAACGCTTGTT
TGGCAGTGAAGGCACGGTTCGTACACCACT|TTGAACGTTACCACACACTTACAACAGAAC
TTTCAGGTTCTGGGGATCCCGGCATAAACG|TACCACACACTTACAACAGAACCATGTTGA
GCGCACCACCGACTCACCGCACGCTCAGAC|CTGACCGGGCGTCCACCCTGGTTCAGAAGA
AACGCTTGTTCGGAGGACCCGATCAGAGAA|CATCTATGCAGGTCCAATAGTTAACTTTAT
TTACCACACACTTACAACAGAACGGTAACG|GTGTTTCAGGTTCTGGGGATCCCGGCATAA
ACAACAGAACTAGTCCACACCAGCGTTTGA|GAGACGCTTGAACGTTACCACACACTTACA
ATGTACCTAGAACCTTCCGTCGGGGAACTC|TGATTCTTCTACAGTGATTTGAACGTTACC
AGTGCGCCCAAATTGAATAGGTGTTTCAGG|AGTCCACACCAGCGTTTGAACGTTACCACA
AGGACCAACCAGGCTATTGTTGAACGTTAC|CGAACTAAACCTGCATGAAAAGCGTTGGAA
TTACCACACACTTACAACAGAACGGGATCC|AACTCTGGTTTATCTCAGATACGGAGGTGA
GGTAGTTTCCTCCCATTGGCAGTGAAGGCA|TTACAACAGAACTCTATTGAACGTTACCAC
ACCACCGACTCACCGCACGCTCAGACTGAG|CCGGGCGTCCACCCTGGTTCAGAAGATCTA
TGGTCGAACGTAACATTTCGAGTAACGTTG|GGGAACTCCTTGTCGCGATCTACAATAAGC
GGTCTTGAACGTTACCACACACTTACAACA|GATACATAGGGCCCAATGTGCATGGCGTTG
TGAACGTTACCACACACTTACAACAGAACT|ACACTTATGTGCCCTTGTTTCACGGTGACG
CTTACAACAGAACGGGATCCGTCCTGCCCG|TATCTCAGATACGGAGGTGAAGGACTCGAA
CGTTACCACACACTTACAACAGAACCGGGA|TCACAGAATTGAACGTTACCACACACTTAC
GTGCATGGCGTTGAACGTTACCACACACTT|CTTACAACAGAACACTTATGTGCCCTTGTT
ATGCTCATCTATGCAGGTCCAATAGTTAAC|TAAGTCCAGACGACTGATAAGTGGCCAGTG
TCGTCCTAGTGCGCCCAAATTGAATAGGTG|CAGAACTAGTCCACACCAGCGTTTGAACGT
TCTACAATAAGCTTGAACGTTACCACACAC|AACAGAACGGGATCCGTCCTGCCCGAGCAC
AAACCTGCATGAAAAGCGTTGGAACGGGTA|GTGGATAGCACCACCGGTTTGAACGTTACC
CCGACATCCAGGCTGATACATAGGGCCCAA|CAACCAGGCTATTGTTGAACGTTACCACAC
GGGATCCGTCCTGCCCGAGCACGAGTTAAC|GAGGTGAAGGACTCGAACTCTCTTAAGAGA
ACAGAACCATGTTGAACGTTACCACACACT|GACCCGATCAGAGAAGAAGGAACTTTATGG
GCACGAGTTAACCAGATATCTTTCGCAAAC|TCTCTTAAGAGAACTGAATGTAACTCCAAC
GGGAGAGTTGAACGTTACCACACACTTACA|ACACACTTACAACAGAACGGTAACGCTTGT
TTTGAACGTTACCACACACTTACAACAGAA|GTAAACACGACTGGTCGAACGTAACATTTC
TTCTTCTACAGTGATTTGAACGTTACCACA|CAGGTTTCAACGGTGGTGAGAAAACTCTGG
AGTCGCGGCTTACCCATCGTCCTAGTGCGC|TACCACACACTTACAACAGAACTAGTCCAC
CATAATAAGTCCAGACGACTGATAAGTGGC|TTCGCAAACGATGCACATTCTAATAAGGCT
GTGCGCCCAAATTGAATAGGTGTTTCAGGT|GTCCACACCAGCGTTTGAACGTTACCACAC
CGTTATCAGTGGATAGCACCACCGGTTTGA|TACCCATCGTCCTAGTGCGCCCAAATTGAA
CGCCACGCGCGCGGTAGTTTCCTCCCATTG|GTTACCACACACTTACAACAGAACTCTATT
TGGTAAGTCGCGGCTTACCCATCGTCCTAG|AACGTTACCACACACTTACAACAGAACTAG
CCTCAGGAACCGAGACGCTTGAACGTTACC|AACGTTACCACACACTTACAACAGAACTGG
GAAAAGCGTTGGAACGGGTAGGGAGAGTTG|CCACCGGTTTGAACGTTACCACACACTTAC
AACCATGTTGAACGTTACCACACACTTTGA|CGATCAGAGAAGAAGGAACTTTATGGTAAA
CACCCTGGTTCAGAAGATCTAGCTTGAACG|TACCACACACTTACAACAGAACTACAACAG
ACAGAACTAGTCCACACCAGCGTTTGAACG|ACGCTTGAACGTTACCACACACTTACAACA
TTGAACGTTACCACACACTTTGAACGTTAC|AGAAGAAGGAACTTTATGGTAAACACGACT
GTCGAACGTAACATTTCGAGTAACGTTGAA|GAACTCCTTGTCGCGATCTACAATAAGCTT
ACGCTTGTTCGGAGGACCCGATCAGAGAAG|ATCTATGCAGGTCCAATAGTTAACTTTATC
GAAGAAGGAACTTTATGGTAAACACGACTG|TATCTAATGTACCTAGAACCTTCCGTCGGG
ACGTTACCACACACTTACAACAGAACTCTA|CTTATGTGCCCTTGTTTCACGGTGACGGGG
CTCCCATTGGCAGTGAAGGCACGGTTCGTA|AACTCTATTGAACGTTACCACACACTTACA
TCTCAAGAGCGCAGAGGACCAACCAGGCTA|ACAGAACTGTGGTTCGAACTAAACCTGCAT
AGCTGATGGGCCAAATTTCCCGTTATCAGT|ACGCTTGGTAAGTCGCGGCTTACCCATCGT
CAGAAGATCTAGCTTGAACGTTACCACACA|TTACAACAGAACTACAACAGAACCTCAGGA
CCGTTATCAGTGGATAGCACCACCGGTTTG|TTACCCATCGTCCTAGTGCGCCCAAATTGA
GGAGAGCATGCTGACCGGGCGTCCACCCTG|ACGTTACCACACACTTTGAACGTTACCACA
TTGCTGTGAATTCTAGCGCACCGACATCCA|GTCTCAAGAGCGCAGAGGACCAACCAGGCT
GTGGCCAGTGAGCCACCATGATTCTTCTAC|AGGCTCATCGAATAAGTACTACAGGTTTCA
TCCCATTGGCAGTGAAGGCACGGTTCGTAC|ACTCTATTGAACGTTACCACACACTTACAA
CTTACCCATCGTCCTAGTGCGCCCAAATTG|ACTTACAACAGAACTAGTCCACACCAGCGT
CATGGCGTTGAACGTTACCACACACTTACA|ACAACAGAACACTTATGTGCCCTTGTTTCA
CATAAACGGGAGAGCATGCTGACCGGGCGT|CATGTTGAACGTTACCACACACTTTGAACG
TTGAACGTTACCACACACTTACAACAGAAC|TAAACACGACTGGTCGAACGTAACATTTCG
CGTTACCACACACTTACAACAGAACGCTTG|GAACTGGCCTTGTCCTCATGCTCATCTATG
AGAAGGAACTTTATGGTAAACACGACTGGT|TCTAATGTACCTAGAACCTTCCGTCGGGGA
CCACGCGCGCGGTAGTTTCCTCCCATTGGC|TACCACACACTTACAACAGAACTCTATTGA
GTTCTGGGGATCCCGGCATAAACGGGAGAG|ACACTTACAACAGAACCATGTTGAACGTTA
ACAGAACTCTATTGAACGTTACCACACACT|CGGTGACGGGGTTCCTTCACAGAATTGAAC
TTATGTGCCCTTGTTTCACGGTGACGGGGT|TACCACACACTTACAACAGAACAGCGACGA
TCGGGGAACTCCTTGTCGCGATCTACAATA|TGAACGTTACCACACACTTACAACAGAACG
AACGTAACATTTCGAGTAACGTTGAACGTT|TCCTTGTCGCGATCTACAATAAGCTTGAAC
GAACCTTCCGTCGGGGAACTCCTTGTCGCG|TACAGTGATTTGAACGTTACCACACACTTA
TGCCCTTGTTTCACGGTGACGGGGTTCCTT|CACACTTACAACAGAACAGCGACGATAACG
GAACAGCGACGATAACGATCCTTAGACAGG|GCTGGGCGCACCACCGACTCACCGCACGCT
TGACCGGGCGTCCACCCTGGTTCAGAAGAT|CACTTTGAACGTTACCACACACTTACAACA
CGTCGGGGAACTCCTTGTCGCGATCTACAA|TTTGAACGTTACCACACACTTACAACAGAA
ATTGAATAGGTGTTTCAGGTTCTGGGGATC|GCGTTTGAACGTTACCACACACTTACAACA
CACCGACATCCAGGCTGATACATAGGGCCC|ACCAACCAGGCTATTGTTGAACGTTACCAC
GTTGAACGTTACCACACACTTACAACAGAA|GAACACTTATGTGCCCTTGTTTCACGGTGA
CAGAACGGTAACGCTTGTCTCGCTGGGCGC|GATCCCGGCATAAACGGGAGAGCATGCTGA
GAACCTCAGGAACCGAGACGCTTGAACGTT|TTGAACGTTACCACACACTTACAACAGAAC
TCCAATAGTTAACTTTATCTAATGTACCTA|TAAGTGGCCAGTGAGCCACCATGATTCTTC
AGTTAACTTTATCTAATGTACCTAGAACCT|GCCAGTGAGCCACCATGATTCTTCTACAGT
CTGTGAATTCTAGCGCACCGACATCCAGGC|TCAAGAGCGCAGAGGACCAACCAGGCTATT
AGGTGTTTCAGGTTCTGGGGATCCCGGCAT|AACGTTACCACACACTTACAACAGAACCAT
TGGGCCAAATTTCCCGTTATCAGTGGATAG|GGTAAGTCGCGGCTTACCCATCGTCCTAGT
ACAATAAGCTTGAACGTTACCACACACTTA|AGAACGGGATCCGTCCTGCCCGAGCACGAG
GTTACCACACACTTACAACAGAACACTTAT|TGGAACGGGTAGGGAGAGTTGAACGTTACC
GAATAGGTGTTTCAGGTTCTGGGGATCCCG|TTTGAACGTTACCACACACTTACAACAGAA
GTTGGAACGGGTAGGGAGAGTTGAACGTTA|TTTGAACGTTACCACACACTTACAACAGAA
AACGTTACCACACACTTACAACAGAACCAT|AACAGAACGCTTGTTCGGAGGACCCGATCA
GAACACTTATGTGCCCTTGTTTCACGGTGA|GAACGTTACCACACACTTACAACAGAACAG
ACACACTTACAACAGAACTGTGGTTCGAAC|CGAAGCTGATGGGCCAAATTTCCCGTTATC
TTGTCCTCATGCTCATCTATGCAGGTCCAA|GGTCATAATAAGTCCAGACGACTGATAAGT
GACAGGGTCGTCCGAAGCTGATGGGCCAAA|CACGCTCAGACTGAGACGCTTGGTAAGTCG
CTGATGGGCCAAATTTCCCGTTATCAGTGG|GCTTGGTAAGTCGCGGCTTACCCATCGTCC
AGGGAGAGTTGAACGTTACCACACACTTAC|CACACACTTACAACAGAACGGTAACGCTTG
CCACACACTTACAACAGAACCGGGAGTCTC|GAATTGAACGTTACCACACACTTACAACAG
CGCACGCTCAGACTGAGACGCTTGGTAAGT|CTGGTTCAGAAGATCTAGCTTGAACGTTAC
AACTAGTCCACACCAGCGTTTGAACGTTAC|TTGAACGTTACCACACACTTACAACAGAAC
TAAGTCGCGGCTTACCCATCGTCCTAGTGC|GTTACCACACACTTACAACAGAACTAGTCC
AGCGACGATAACGATCCTTAGACAGGGTCG|GGCGCACCACCGACTCACCGCACGCTCAGA
GGGAACTCCTTGTCGCGATCTACAATAAGC|ACGTTACCACACACTTACAACAGAACGGGA
ACGCTTGGTAAGTCGCGGCTTACCCATCGT|GCTTGAACGTTACCACACACTTACAACAGA
ACTTTATGGTAAACACGACTGGTCGAACGT|TACCTAGAACCTTCCGTCGGGGAACTCCTT
GGTAGGGAGAGTTGAACGTTACCACACACT|TACCACACACTTACAACAGAACGGTAACGC
GACTGAGACGCTTGGTAAGTCGCGGCTTAC|AGATCTAGCTTGAACGTTACCACACACTTA
ACCACTTAACATTGCTGTGAATTCTAGCGC|CAGAACCGGGAGTCTCAAGAGCGCAGAGGA
GTTGAACGTTACCACACACTTACAACAGAA|AAGCTTGAACGTTACCACACACTTACAACA
GTTACCACACACTTACAACAGAACTGTGGT|GTCGTCCGAAGCTGATGGGCCAAATTTCCC
AGTGGATAGCACCACCGGTTTGAACGTTAC|CGTCCTAGTGCGCCCAAATTGAATAGGTGT
ACACTTACAACAGAACAGCGACGATAACGA|AACGCTTGTCTCGCTGGGCGCACCACCGAC
ATGATTCTTCTACAGTGATTTGAACGTTAC|ACTACAGGTTTCAACGGTGGTGAGAAAACT
TTGAACGTTACCACACACTTACAACAGAAC|TCCGTCCTGCCCGAGCACGAGTTAACCAGA
GCGCCCAAATTGAATAGGTGTTTCAGGTTC|CCACACCAGCGTTTGAACGTTACCACACAC
TAGTTTCCTCCCATTGGCAGTGAAGGCACG|ACAACAGAACTCTATTGAACGTTACCACAC
AACGTTACCACACACTTACAACAGAACGGT|ATAGGTGTTTCAGGTTCTGGGGATCCCGGC
ACTGGTCGAACGTAACATTTCGAGTAACGT|CGGGGAACTCCTTGTCGCGATCTACAATAA
GTTGAACGTTACCACACACTTACAACAGAA|TTACAACAGAACGGTAACGCTTGTCTCGCT
CCCAAATTGAATAGGTGTTTCAGGTTCTGG|CACCAGCGTTTGAACGTTACCACACACTTA
AAATTGAATAGGTGTTTCAGGTTCTGGGGA|CAGCGTTTGAACGTTACCACACACTTACAA
GAAGGAACTTTATGGTAAACACGACTGGTC|CTAATGTACCTAGAACCTTCCGTCGGGGAA
TGTTGAACGTTACCACACACTTACAACAGA|AAAAGCGTTGGAACGGGTAGGGAGAGTTGA
CCACACACTTACAACAGAACTAGTCCACAC|CTCAGGAACCGAGACGCTTGAACGTTACCA
ACTTACAACAGAACACTTATGTGCCCTTGT|AGGGAGAGTTGAACGTTACCACACACTTAC
CGTTACCACACACTTACAACAGAACTACAA|ACGACTGGTCGAACGTAACATTTCGAGTAA
GGGTAGGGAGAGTTGAACGTTACCACACAC|TTACCACACACTTACAACAGAACGGTAACG
GGGGTTCCTTCACAGAATTGAACGTTACCA|GACGATAACGATCCTTAGACAGGGTCGTCC
TGATTTGAACGTTACCACACACTTACAACA|GGTGGTGAGAAAACTCTGGTTTATCTCAGA
AGAGCGCAGAGGACCAACCAGGCTATTGTT|ACTGTGGTTCGAACTAAACCTGCATGAAAA
GGTGACGGGGTTCCTTCACAGAATTGAACG|AACAGCGACGATAACGATCCTTAGACAGGG
TACAACAGAACTGTGGTTCGAACTAAACCT|GATGGGCCAAATTTCCCGTTATCAGTGGAT
TGACGGGGTTCCTTCACAGAATTGAACGTT|CAGCGACGATAACGATCCTTAGACAGGGTC
ATCCGTCCTGCCCGAGCACGAGTTAACCAG|GTGAAGGACTCGAACTCTCTTAAGAGAACT
ATCCAGGCTGATACATAGGGCCCAATGTGC|AGGCTATTGTTGAACGTTACCACACACTTA
ACAGTGATTTGAACGTTACCACACACTTAC|CAACGGTGGTGAGAAAACTCTGGTTTATCT
CGGCATAAACGGGAGAGCATGCTGACCGGG|AACCATGTTGAACGTTACCACACACTTTGA
TCCACACCAGCGTTTGAACGTTACCACACA|GTTACCACACACTTACAACAGAACGCTTGT
CTTATGTGCCCTTGTTTCACGGTGACGGGG|TTACCACACACTTACAACAGAACAGCGACG
TTGAACGTTACCACACACTTACAACAGAAC|CAACAGAACTGGCCTTGTCCTCATGCTCAT
CACTTACAACAGAACACTTATGTGCCCTTG|TAGGGAGAGTTGAACGTTACCACACACTTA
GACGCTTGGTAAGTCGCGGCTTACCCATCG|AGCTTGAACGTTACCACACACTTACAACAG
TTCCGTCGGGGAACTCCTTGTCGCGATCTA|TGATTTGAACGTTACCACACACTTACAACA
ATGTGCATGGCGTTGAACGTTACCACACAC|CACTTACAACAGAACACTTATGTGCCCTTG
TACCACACACTTACAACAGAACCATGTTGA|AACGCTTGTTCGGAGGACCCGATCAGAGAA
CCCGATCAGAGAAGAAGGAACTTTATGGTA|TAGTTAACTTTATCTAATGTACCTAGAACC
GCATGAAAAGCGTTGGAACGGGTAGGGAGA|AGCACCACCGGTTTGAACGTTACCACACAC
GTTACCACACACTTACAACAGAACCATGTT|AGAACGCTTGTTCGGAGGACCCGATCAGAG
CACACTTACAACAGAACTACAACAGAACCT|TCGAACGTAACATTTCGAGTAACGTTGAAC
CTATTGAACGTTACCACACACTTACAACAG|GGGTTCCTTCACAGAATTGAACGTTACCAC
ACGATAACGATCCTTAGACAGGGTCGTCCG|CACCACCGACTCACCGCACGCTCAGACTGA
AACTCGGTCATAATAAGTCCAGACGACTGA|AGATATCTTTCGCAAACGATGCACATTCTA
CTGGTCGAACGTAACATTTCGAGTAACGTT|GGGGAACTCCTTGTCGCGATCTACAATAAG
TGAACGTTACCACACACTTTGAACGTTACC|GAAGAAGGAACTTTATGGTAAACACGACTG
GAACGTTACCACACACTTACAACAGAACCG|CCTTCACAGAATTGAACGTTACCACACACT
CCACACACTTTGAACGTTACCACACACTTA|ACTTTATGGTAAACACGACTGGTCGAACGT
ACCATGTTGAACGTTACCACACACTTTGAA|GATCAGAGAAGAAGGAACTTTATGGTAAAC
CAACAGAACTGGCCTTGTCCTCATGCTCAT|TTACAACAGAACTCGGTCATAATAAGTCCA
GAACGTTACCACACACTTACAACAGAACGC|ACAGAACTGGCCTTGTCCTCATGCTCATCT
ACAACAGAACACTTATGTGCCCTTGTTTCA|AGAGTTGAACGTTACCACACACTTACAACA
TCCTTCACAGAATTGAACGTTACCACACAC|TAACGATCCTTAGACAGGGTCGTCCGAAGC
GATCAGAGAAGAAGGAACTTTATGGTAAAC|TTAACTTTATCTAATGTACCTAGAACCTTC
GTTACCACACACTTACAACAGAACTAGTCC|GAACCTCAGGAACCGAGACGCTTGAACGTT
CCAATAGTTAACTTTATCTAATGTACCTAG|AAGTGGCCAGTGAGCCACCATGATTCTTCT
GTCCTAGTGCGCCCAAATTGAATAGGTGTT|GAACTAGTCCACACCAGCGTTTGAACGTTA
AACGTTACCACACACTTACAACAGAACTGG|TTGAACGTTACCACACACTTACAACAGAAC
CGGTTTGAACGTTACCACACACTTACAACA|AAATTGAATAGGTGTTTCAGGTTCTGGGGA
ACAACAGAACTCTATTGAACGTTACCACAC|TCACGGTGACGGGGTTCCTTCACAGAATTG
CCAAATTGAATAGGTGTTTCAGGTTCTGGG|ACCAGCGTTTGAACGTTACCACACACTTAC
ACCACACACTTACAACAGAACGCTTGTTCG|TGGCCTTGTCCTCATGCTCATCTATGCAGG
CAAGAGCGCAGAGGACCAACCAGGCTATTG|GAACTGTGGTTCGAACTAAACCTGCATGAA
GTAACGTTGAACGTTACCACACACTTACAA|ACAATAAGCTTGAACGTTACCACACACTTA
ATTGAACGTTACCACACACTTACAACAGAA|AGACAGGGTCGTCCGAAGCTGATGGGCCAA
TCTAGCTTGAACGTTACCACACACTTACAA|AGAACTACAACAGAACCTCAGGAACCGAGA
GCACCACCGGTTTGAACGTTACCACACACT|TGCGCCCAAATTGAATAGGTGTTTCAGGTT
AACTAAACCTGCATGAAAAGCGTTGGAACG|ATCAGTGGATAGCACCACCGGTTTGAACGT
TACCACACACTTACAACAGAACACTTATGT|GAACGGGTAGGGAGAGTTGAACGTTACCAC
CGAGTAACGTTGAACGTTACCACACACTTA|TCTACAATAAGCTTGAACGTTACCACACAC
CGGGGAACTCCTTGTCGCGATCTACAATAA|GAACGTTACCACACACTTACAACAGAACGG
CACGCTCAGACTGAGACGCTTGGTAAGTCG|GGTTCAGAAGATCTAGCTTGAACGTTACCA
TTACCACACACTTACAACAGAACTCTATTG|ATGTGCCCTTGTTTCACGGTGACGGGGTTC
TGAACGTTACCACACACTTACAACAGAACA|ACAACAGAACGGTAACGCTTGTCTCGCTGG
ACGCTTGTCTCGCTGGGCGCACCACCGACT|TAAACGGGAGAGCATGCTGACCGGGCGTCC
TGAGCCACCATGATTCTTCTACAGTGATTT|CGAATAAGTACTACAGGTTTCAACGGTGGT
ACCACACACTTACAACAGAACTGGCCTTGT|GTTACCACACACTTACAACAGAACTCGGTC
GTTTCACGGTGACGGGGTTCCTTCACAGAA|ACAACAGAACAGCGACGATAACGATCCTTA
CACTTACAACAGAACTAGTCCACACCAGCG|GAACCGAGACGCTTGAACGTTACCACACAC
CGTACACCACTTAACATTGCTGTGAATTCT|TACAACAGAACCGGGAGTCTCAAGAGCGCA
CGCGGCTTACCCATCGTCCTAGTGCGCCCA|CACACACTTACAACAGAACTAGTCCACACC
CTTGGTAAGTCGCGGCTTACCCATCGTCCT|TGAACGTTACCACACACTTACAACAGAACT
AAGGAACTTTATGGTAAACACGACTGGTCG|TAATGTACCTAGAACCTTCCGTCGGGGAAC
CAGAATTGAACGTTACCACACACTTACAAC|CCTTAGACAGGGTCGTCCGAAGCTGATGGG
CTTACAACAGAACGGTAACGCTTGTCTCGC|TTCTGGGGATCCCGGCATAAACGGGAGAGC
GGCTATTGTTGAACGTTACCACACACTTAC|TGCATGAAAAGCGTTGGAACGGGTAGGGAG
CTTGTCTCGCTGGGCGCACCACCGACTCAC|ACGGGAGAGCATGCTGACCGGGCGTCCACC
GTTACCACACACTTACAACAGAACGGTAAC|GGTGTTTCAGGTTCTGGGGATCCCGGCATA
CGTCCTGCCCGAGCACGAGTTAACCAGATA|AAGGACTCGAACTCTCTTAAGAGAACTGAA
AAACGGGAGAGCATGCTGACCGGGCGTCCA|GTTGAACGTTACCACACACTTTGAACGTTA
TAACGATCCTTAGACAGGGTCGTCCGAAGC|ACCGACTCACCGCACGCTCAGACTGAGACG
ATCCCGGCATAAACGGGAGAGCATGCTGAC|ACAGAACCATGTTGAACGTTACCACACACT
ACCACACACTTACAACAGAACTCTATTGAA|GTGCCCTTGTTTCACGGTGACGGGGTTCCT
CCACACACTTACAACAGAACTGTGGTTCGA|TCCGAAGCTGATGGGCCAAATTTCCCGTTA
CTCGGTCATAATAAGTCCAGACGACTGATA|ATATCTTTCGCAAACGATGCACATTCTAAT
GAACGTAACATTTCGAGTAACGTTGAACGT|CTCCTTGTCGCGATCTACAATAAGCTTGAA
CTTTGAACGTTACCACACACTTACAACAGA|GGTAAACACGACTGGTCGAACGTAACATTT
TGAACGTTACCACACACTTACAACAGAACT|AAACACGACTGGTCGAACGTAACATTTCGA
AATAAGCTTGAACGTTACCACACACTTACA|AACGGGATCCGTCCTGCCCGAGCACGAGTT
TCTTGAACGTTACCACACACTTACAACAGA|TACATAGGGCCCAATGTGCATGGCGTTGAA
AATGTACCTAGAACCTTCCGTCGGGGAACT|ATGATTCTTCTACAGTGATTTGAACGTTAC
ACAGCGACGATAACGATCCTTAGACAGGGT|TGGGCGCACCACCGACTCACCGCACGCTCA
CTGACCGGGCGTCCACCCTGGTTCAGAAGA|ACACTTTGAACGTTACCACACACTTACAAC
AGCATGCTGACCGGGCGTCCACCCTGGTTC|TACCACACACTTTGAACGTTACCACACACT
CACTTACAACAGAACGGGATCCGTCCTGCC|TTTATCTCAGATACGGAGGTGAAGGACTCG
GCGCAGAGGACCAACCAGGCTATTGTTGAA|GTGGTTCGAACTAAACCTGCATGAAAAGCG
GTTACCACACACTTACAACAGAACTACAAC|CGACTGGTCGAACGTAACATTTCGAGTAAC
GTGGATAGCACCACCGGTTTGAACGTTACC|GTCCTAGTGCGCCCAAATTGAATAGGTGTT
GAACGTTACCACACACTTACAACAGAACGG|AATAGGTGTTTCAGGTTCTGGGGATCCCGG
ACAACAGAACCATGTTGAACGTTACCACAC|GAGGACCCGATCAGAGAAGAAGGAACTTTA
TGAATAGGTGTTTCAGGTTCTGGGGATCCC|GTTTGAACGTTACCACACACTTACAACAGA
CAGAACTACAACAGAACCTCAGGAACCGAG|ATTTCGAGTAACGTTGAACGTTACCACACA
CGGGATCCGTCCTGCCCGAGCACGAGTTAA|GGAGGTGAAGGACTCGAACTCTCTTAAGAG
ATCGTCCTAGTGCGCCCAAATTGAATAGGT|ACAGAACTAGTCCACACCAGCGTTTGAACG
GGCGTCCACCCTGGTTCAGAAGATCTAGCT|GAACGTTACCACACACTTACAACAGAACTA
AGCGCACCGACATCCAGGCTGATACATAGG|GAGGACCAACCAGGCTATTGTTGAACGTTA
GTTACCACACACTTACAACAGAACTCTATT|TATGTGCCCTTGTTTCACGGTGACGGGGTT
AACGTTACCACACACTTACAACAGAACCGG|CTTCACAGAATTGAACGTTACCACACACTT
CGTCCTAGTGCGCCCAAATTGAATAGGTGT|AGAACTAGTCCACACCAGCGTTTGAACGTT
CTCAGGAACCGAGACGCTTGAACGTTACCA|ACGTTACCACACACTTACAACAGAACTGGC
TCGGAGGACCCGATCAGAGAAGAAGGAACT|AGGTCCAATAGTTAACTTTATCTAATGTAC
TATGTGCCCTTGTTTCACGGTGACGGGGTT|ACCACACACTTACAACAGAACAGCGACGAT
CCACCGGTTTGAACGTTACCACACACTTAC|GCCCAAATTGAATAGGTGTTTCAGGTTCTG
ACGCCACGCGCGCGGTAGTTTCCTCCCATT|CGTTACCACACACTTACAACAGAACTCTAT
GACGACTGATAAGTGGCCAGTGAGCCACCA|CACATTCTAATAAGGCTCATCGAATAAGTA
CGTTACCACACACTTACAACAGAACTCTAT|TTATGTGCCCTTGTTTCACGGTGACGGGGT
ACCATGATTCTTCTACAGTGATTTGAACGT|AGTACTACAGGTTTCAACGGTGGTGAGAAA
AGACTGAGACGCTTGGTAAGTCGCGGCTTA|AAGATCTAGCTTGAACGTTACCACACACTT
GACTCACCGCACGCTCAGACTGAGACGCTT|GTCCACCCTGGTTCAGAAGATCTAGCTTGA
TTGGAACGGGTAGGGAGAGTTGAACGTTAC|TTGAACGTTACCACACACTTACAACAGAAC
CCTTCACAGAATTGAACGTTACCACACACT|AACGATCCTTAGACAGGGTCGTCCGAAGCT
GTACACCACTTAACATTGCTGTGAATTCTA|ACAACAGAACCGGGAGTCTCAAGAGCGCAG
CAGAGAAGAAGGAACTTTATGGTAAACACG|ACTTTATCTAATGTACCTAGAACCTTCCGT
GCCAGTGAGCCACCATGATTCTTCTACAGT|CTCATCGAATAAGTACTACAGGTTTCAACG
TCGAGTAACGTTGAACGTTACCACACACTT|ATCTACAATAAGCTTGAACGTTACCACACA
TAATGTACCTAGAACCTTCCGTCGGGGAAC|CATGATTCTTCTACAGTGATTTGAACGTTA
CAGAACTGGCCTTGTCCTCATGCTCATCTA|CAACAGAACTCGGTCATAATAAGTCCAGAC
ACTACAACAGAACCTCAGGAACCGAGACGC|CGAGTAACGTTGAACGTTACCACACACTTA
ACGACTGGTCGAACGTAACATTTCGAGTAA|CGTCGGGGAACTCCTTGTCGCGATCTACAA
AACGTTACCACACACTTACAACAGAACTAC|ACACGACTGGTCGAACGTAACATTTCGAGT
TAGTTAACTTTATCTAATGTACCTAGAACC|GGCCAGTGAGCCACCATGATTCTTCTACAG
AATGTGCATGGCGTTGAACGTTACCACACA|ACACTTACAACAGAACACTTATGTGCCCTT
ACCCATCGTCCTAGTGCGCCCAAATTGAAT|TACAACAGAACTAGTCCACACCAGCGTTTG
AACAGAACCATGTTGAACGTTACCACACAC|GGACCCGATCAGAGAAGAAGGAACTTTATG
ACACACTTACAACAGAACCGGGAGTCTCAA|ATTGAACGTTACCACACACTTACAACAGAA
GATAAGTGGCCAGTGAGCCACCATGATTCT|TAATAAGGCTCATCGAATAAGTACTACAGG
ACATTTCGAGTAACGTTGAACGTTACCACA|TCGCGATCTACAATAAGCTTGAACGTTACC
CGAACGTAACATTTCGAGTAACGTTGAACG|ACTCCTTGTCGCGATCTACAATAAGCTTGA
AGAACTACAACAGAACCTCAGGAACCGAGA|TTTCGAGTAACGTTGAACGTTACCACACAC
AAGGCACGGTTCGTACACCACTTAACATTG|TACCACACACTTACAACAGAACCGGGAGTC
ATCAGTGGATAGCACCACCGGTTTGAACGT|CATCGTCCTAGTGCGCCCAAATTGAATAGG
TGTGCATGGCGTTGAACGTTACCACACACT|ACTTACAACAGAACACTTATGTGCCCTTGT
TCGAACGTAACATTTCGAGTAACGTTGAAC|AACTCCTTGTCGCGATCTACAATAAGCTTG
CACACTTACAACAGAACGGGATCCGTCCTG|GGTTTATCTCAGATACGGAGGTGAAGGACT
CACACCAGCGTTTGAACGTTACCACACACT|TACCACACACTTACAACAGAACGCTTGTTC
TGGTAAACACGACTGGTCGAACGTAACATT|GAACCTTCCGTCGGGGAACTCCTTGTCGCG
TCTGGGGATCCCGGCATAAACGGGAGAGCA|ACTTACAACAGAACCATGTTGAACGTTACC
ACGTTACCACACACTTACAACAGAACTGGC|TGAACGTTACCACACACTTACAACAGAACT
CACACACTTACAACAGAACTACAACAGAAC|GGTCGAACGTAACATTTCGAGTAACGTTGA
AGCTTGAACGTTACCACACACTTACAACAG|GGATCCGTCCTGCCCGAGCACGAGTTAACC
TAATAAGTCCAGACGACTGATAAGTGGCCA|CGCAAACGATGCACATTCTAATAAGGCTCA
GGTTTGAACGTTACCACACACTTACAACAG|AATTGAATAGGTGTTTCAGGTTCTGGGGAT
CACCGGTTTGAACGTTACCACACACTTACA|CCCAAATTGAATAGGTGTTTCAGGTTCTGG
GGTCATAATAAGTCCAGACGACTGATAAGT|TCTTTCGCAAACGATGCACATTCTAATAAG
ACTTACAACAGAACTCTATTGAACGTTACC|TGTTTCACGGTGACGGGGTTCCTTCACAGA
CGAACTAAACCTGCATGAAAAGCGTTGGAA|TTATCAGTGGATAGCACCACCGGTTTGAAC
TCGCGGCTTACCCATCGTCCTAGTGCGCCC|CCACACACTTACAACAGAACTAGTCCACAC
ACGTTACCACACACTTACAACAGAACGCCA|GGGCCCAATGTGCATGGCGTTGAACGTTAC
ACAGAACCTCAGGAACCGAGACGCTTGAAC|ACGTTGAACGTTACCACACACTTACAACAG
TTGTCGCGATCTACAATAAGCTTGAACGTT|CACACTTACAACAGAACGGGATCCGTCCTG
AGAACTGTGGTTCGAACTAAACCTGCATGA|CCAAATTTCCCGTTATCAGTGGATAGCACC
TGAACGTTACCACACACTTACAACAGAACG|GAATAGGTGTTTCAGGTTCTGGGGATCCCG
AGAACTGGCCTTGTCCTCATGCTCATCTAT|AACAGAACTCGGTCATAATAAGTCCAGACG
TTCCTTCACAGAATTGAACGTTACCACACA|ATAACGATCCTTAGACAGGGTCGTCCGAAG
TGCGCCCAAATTGAATAGGTGTTTCAGGTT|TCCACACCAGCGTTTGAACGTTACCACACA
GAGGACCCGATCAGAGAAGAAGGAACTTTA|TCCAATAGTTAACTTTATCTAATGTACCTA
TACAACAGAACGGTAACGCTTGTCTCGCTG|CTGGGGATCCCGGCATAAACGGGAGAGCAT
AACGTTACCACACACTTACAACAGAACGGG|AGAAAACTCTGGTTTATCTCAGATACGGAG
AGTGATTTGAACGTTACCACACACTTACAA|ACGGTGGTGAGAAAACTCTGGTTTATCTCA
TACCACACACTTACAACAGAACGCTTGTTC|CTGGCCTTGTCCTCATGCTCATCTATGCAG
GCTTGAACGTTACCACACACTTACAACAGA|GATCCGTCCTGCCCGAGCACGAGTTAACCA
ACGTAACATTTCGAGTAACGTTGAACGTTA|CCTTGTCGCGATCTACAATAAGCTTGAACG
ATTTCGAGTAACGTTGAACGTTACCACACA|GCGATCTACAATAAGCTTGAACGTTACCAC
CGGTTCGTACACCACTTAACATTGCTGTGA|ACACTTACAACAGAACCGGGAGTCTCAAGA
ACAACAGAACGGTAACGCTTGTCTCGCTGG|TGGGGATCCCGGCATAAACGGGAGAGCATG
CTACAACAGAACCTCAGGAACCGAGACGCT|GAGTAACGTTGAACGTTACCACACACTTAC
TTCTAGCGCACCGACATCCAGGCTGATACA|CGCAGAGGACCAACCAGGCTATTGTTGAAC
TGGTTCAGAAGATCTAGCTTGAACGTTACC|CACACTTACAACAGAACTACAACAGAACCT
AGAACTCTATTGAACGTTACCACACACTTA|GTGACGGGGTTCCTTCACAGAATTGAACGT
CTCAAGAGCGCAGAGGACCAACCAGGCTAT|CAGAACTGTGGTTCGAACTAAACCTGCATG
GCTGATGGGCCAAATTTCCCGTTATCAGTG|CGCTTGGTAAGTCGCGGCTTACCCATCGTC
CACCATGATTCTTCTACAGTGATTTGAACG|AAGTACTACAGGTTTCAACGGTGGTGAGAA
ACCACACACTTACAACAGAACGCCACGCGC|CAATGTGCATGGCGTTGAACGTTACCACAC
ACTTACAACAGAACTAGTCCACACCAGCGT|AACCGAGACGCTTGAACGTTACCACACACT
TCATGCTCATCTATGCAGGTCCAATAGTTA|AATAAGTCCAGACGACTGATAAGTGGCCAG
GAACTAAACCTGCATGAAAAGCGTTGGAAC|TATCAGTGGATAGCACCACCGGTTTGAACG
GGAGTCTCAAGAGCGCAGAGGACCAACCAG|TACAACAGAACTGTGGTTCGAACTAAACCT
CAACAGAACTACAACAGAACCTCAGGAACC|AACATTTCGAGTAACGTTGAACGTTACCAC
CCAAATTTCCCGTTATCAGTGGATAGCACC|AGTCGCGGCTTACCCATCGTCCTAGTGCGC
ACACTTACAACAGAACGGTAACGCTTGTCT|AGGTTCTGGGGATCCCGGCATAAACGGGAG
ACAGGGTCGTCCGAAGCTGATGGGCCAAAT|ACGCTCAGACTGAGACGCTTGGTAAGTCGC
AGGCACGGTTCGTACACCACTTAACATTGC|ACCACACACTTACAACAGAACCGGGAGTCT
CTCAGACTGAGACGCTTGGTAAGTCGCGGC|CAGAAGATCTAGCTTGAACGTTACCACACA
CACTTTGAACGTTACCACACACTTACAACA|ATGGTAAACACGACTGGTCGAACGTAACAT
CGACTCACCGCACGCTCAGACTGAGACGCT|CGTCCACCCTGGTTCAGAAGATCTAGCTTG
ACCGACTCACCGCACGCTCAGACTGAGACG|GGCGTCCACCCTGGTTCAGAAGATCTAGCT
CAACAGAACGCTTGTTCGGAGGACCCGATC|CATGCTCATCTATGCAGGTCCAATAGTTAA
TACAACAGAACCATGTTGAACGTTACCACA|GGAGGACCCGATCAGAGAAGAAGGAACTTT
CAATAGTTAACTTTATCTAATGTACCTAGA|AGTGGCCAGTGAGCCACCATGATTCTTCTA
TCTCGCTGGGCGCACCACCGACTCACCGCA|GAGAGCATGCTGACCGGGCGTCCACCCTGG
AACAGAACACTTATGTGCCCTTGTTTCACG|AGTTGAACGTTACCACACACTTACAACAGA
GTTCGTACACCACTTAACATTGCTGTGAAT|ACTTACAACAGAACCGGGAGTCTCAAGAGC
GACGGGGTTCCTTCACAGAATTGAACGTTA|AGCGACGATAACGATCCTTAGACAGGGTCG
GGGAGTCTCAAGAGCGCAGAGGACCAACCA|TTACAACAGAACTGTGGTTCGAACTAAACC
CAGGCTATTGTTGAACGTTACCACACACTT|CCTGCATGAAAAGCGTTGGAACGGGTAGGG
TCGGTCATAATAAGTCCAGACGACTGATAA|TATCTTTCGCAAACGATGCACATTCTAATA
CCAGACGACTGATAAGTGGCCAGTGAGCCA|ATGCACATTCTAATAAGGCTCATCGAATAA
AAACACGACTGGTCGAACGTAACATTTCGA|CTTCCGTCGGGGAACTCCTTGTCGCGATCT
AATTCTAGCGCACCGACATCCAGGCTGATA|AGCGCAGAGGACCAACCAGGCTATTGTTGA
AAATTTCCCGTTATCAGTGGATAGCACCAC|TCGCGGCTTACCCATCGTCCTAGTGCGCCC
ACGTTACCACACACTTACAACAGAACGCTT|AGAACTGGCCTTGTCCTCATGCTCATCTAT
GATCCGTCCTGCCCGAGCACGAGTTAACCA|GGTGAAGGACTCGAACTCTCTTAAGAGAAC
CCGGCATAAACGGGAGAGCATGCTGACCGG|GAACCATGTTGAACGTTACCACACACTTTG
AACAGAACCTCAGGAACCGAGACGCTTGAA|AACGTTGAACGTTACCACACACTTACAACA
GATCCCGGCATAAACGGGAGAGCATGCTGA|AACAGAACCATGTTGAACGTTACCACACAC
GGGATCCCGGCATAAACGGGAGAGCATGCT|ACAACAGAACCATGTTGAACGTTACCACAC
TCGTCCGAAGCTGATGGGCCAAATTTCCCG|AGACTGAGACGCTTGGTAAGTCGCGGCTTA
CCCGTTATCAGTGGATAGCACCACCGGTTT|CTTACCCATCGTCCTAGTGCGCCCAAATTG
GCAGGTCCAATAGTTAACTTTATCTAATGT|ACTGATAAGTGGCCAGTGAGCCACCATGAT
CTAATGTACCTAGAACCTTCCGTCGGGGAA|CCATGATTCTTCTACAGTGATTTGAACGTT
ACTTATGTGCCCTTGTTTCACGGTGACGGG|GTTACCACACACTTACAACAGAACAGCGAC
TGCTGTGAATTCTAGCGCACCGACATCCAG|TCTCAAGAGCGCAGAGGACCAACCAGGCTA
CTTAACATTGCTGTGAATTCTAGCGCACCG|ACCGGGAGTCTCAAGAGCGCAGAGGACCAA
TCACCGCACGCTCAGACTGAGACGCTTGGT|CACCCTGGTTCAGAAGATCTAGCTTGAACG
AGGAACTTTATGGTAAACACGACTGGTCGA|AATGTACCTAGAACCTTCCGTCGGGGAACT
ACTGAGACGCTTGGTAAGTCGCGGCTTACC|GATCTAGCTTGAACGTTACCACACACTTAC
GTTCCTTCACAGAATTGAACGTTACCACAC|GATAACGATCCTTAGACAGGGTCGTCCGAA
TAAGTCCAGACGACTGATAAGTGGCCAGTG|AAACGATGCACATTCTAATAAGGCTCATCG
TTACAACAGAACTAGTCCACACCAGCGTTT|CCGAGACGCTTGAACGTTACCACACACTTA
ACAACAGAACTCGGTCATAATAAGTCCAGA|GTTAACCAGATATCTTTCGCAAACGATGCA
ACACTTACAACAGAACTAGTCCACACCAGC|GGAACCGAGACGCTTGAACGTTACCACACA
AGGGCCCAATGTGCATGGCGTTGAACGTTA|TTACCACACACTTACAACAGAACACTTATG
CACACACTTACAACAGAACCGGGAGTCTCA|AATTGAACGTTACCACACACTTACAACAGA
TTGTTTCACGGTGACGGGGTTCCTTCACAG|TTACAACAGAACAGCGACGATAACGATCCT
ACCGACATCCAGGCTGATACATAGGGCCCA|CCAACCAGGCTATTGTTGAACGTTACCACA
CTCCTTGTCGCGATCTACAATAAGCTTGAA|ACCACACACTTACAACAGAACGGGATCCGT
TGAAAAGCGTTGGAACGGGTAGGGAGAGTT|ACCACCGGTTTGAACGTTACCACACACTTA
CACTTAACATTGCTGTGAATTCTAGCGCAC|GAACCGGGAGTCTCAAGAGCGCAGAGGACC
AATTGAACGTTACCACACACTTACAACAGA|TAGACAGGGTCGTCCGAAGCTGATGGGCCA
CTTGAACGTTACCACACACTTACAACAGAA|ATCCGTCCTGCCCGAGCACGAGTTAACCAG
TACCACACACTTACAACAGAACTGTGGTTC|CGTCCGAAGCTGATGGGCCAAATTTCCCGT
AACCTCAGGAACCGAGACGCTTGAACGTTA|TGAACGTTACCACACACTTACAACAGAACT
CTAGTCCACACCAGCGTTTGAACGTTACCA|GAACGTTACCACACACTTACAACAGAACGC
CCACACACTTACAACAGAACTACAACAGAA|TGGTCGAACGTAACATTTCGAGTAACGTTG
ACCTCAGGAACCGAGACGCTTGAACGTTAC|GAACGTTACCACACACTTACAACAGAACTG
CAGAACGGGATCCGTCCTGCCCGAGCACGA|GATACGGAGGTGAAGGACTCGAACTCTCTT
TTACAACAGAACCATGTTGAACGTTACCAC|CGGAGGACCCGATCAGAGAAGAAGGAACTT
ACAACAGAACTGGCCTTGTCCTCATGCTCA|CTTACAACAGAACTCGGTCATAATAAGTCC
ACCTGCATGAAAAGCGTTGGAACGGGTAGG|GGATAGCACCACCGGTTTGAACGTTACCAC
GGCAGTGAAGGCACGGTTCGTACACCACTT|TGAACGTTACCACACACTTACAACAGAACC
TAGGTGTTTCAGGTTCTGGGGATCCCGGCA|GAACGTTACCACACACTTACAACAGAACCA
TACCACACACTTACAACAGAACTCGGTCAT|GCCCGAGCACGAGTTAACCAGATATCTTTC
AACGGGTAGGGAGAGTTGAACGTTACCACA|ACGTTACCACACACTTACAACAGAACGGTA
ATGCAGGTCCAATAGTTAACTTTATCTAAT|CGACTGATAAGTGGCCAGTGAGCCACCATG
CGCGATCTACAATAAGCTTGAACGTTACCA|CTTACAACAGAACGGGATCCGTCCTGCCCG
GAACGTTACCACACACTTACAACAGAACGG|GAGAAAACTCTGGTTTATCTCAGATACGGA
AGTCCACACCAGCGTTTGAACGTTACCACA|ACGTTACCACACACTTACAACAGAACGCTT
CCTAGAACCTTCCGTCGGGGAACTCCTTGT|CTTCTACAGTGATTTGAACGTTACCACACA
ACTTTATCTAATGTACCTAGAACCTTCCGT|TGAGCCACCATGATTCTTCTACAGTGATTT
GAACGTTACCACACACTTACAACAGAACTG|CAGGGTCGTCCGAAGCTGATGGGCCAAATT
CGCGCGGTAGTTTCCTCCCATTGGCAGTGA|CACACTTACAACAGAACTCTATTGAACGTT
CCTCATGCTCATCTATGCAGGTCCAATAGT|ATAATAAGTCCAGACGACTGATAAGTGGCC
TCGAACTAAACCTGCATGAAAAGCGTTGGA|GTTATCAGTGGATAGCACCACCGGTTTGAA
ACATTGCTGTGAATTCTAGCGCACCGACAT|GGAGTCTCAAGAGCGCAGAGGACCAACCAG
TACCTAGAACCTTCCGTCGGGGAACTCCTT|TTCTTCTACAGTGATTTGAACGTTACCACA
CACACACTTACAACAGAACCATGTTGAACG|GCTTGTTCGGAGGACCCGATCAGAGAAGAA
GACGATAACGATCCTTAGACAGGGTCGTCC|GCACCACCGACTCACCGCACGCTCAGACTG
CATGTTGAACGTTACCACACACTTTGAACG|TCAGAGAAGAAGGAACTTTATGGTAAACAC
GAGCGCAGAGGACCAACCAGGCTATTGTTG|CTGTGGTTCGAACTAAACCTGCATGAAAAG
GGCATAAACGGGAGAGCATGCTGACCGGGC|ACCATGTTGAACGTTACCACACACTTTGAA
GTACCTAGAACCTTCCGTCGGGGAACTCCT|ATTCTTCTACAGTGATTTGAACGTTACCAC
CGTTACCACACACTTTGAACGTTACCACAC|AAGGAACTTTATGGTAAACACGACTGGTCG
CCGACTCACCGCACGCTCAGACTGAGACGC|GCGTCCACCCTGGTTCAGAAGATCTAGCTT
GGTAAACACGACTGGTCGAACGTAACATTT|AACCTTCCGTCGGGGAACTCCTTGTCGCGA
CTGGCCTTGTCCTCATGCTCATCTATGCAG|GAACTCGGTCATAATAAGTCCAGACGACTG
CTATGCAGGTCCAATAGTTAACTTTATCTA|GACGACTGATAAGTGGCCAGTGAGCCACCA
GCTTGAACGTTACCACACACTTACAACAGA|TACAACAGAACTGGCCTTGTCCTCATGCTC
ATTGTTGAACGTTACCACACACTTACAACA|TGAAAAGCGTTGGAACGGGTAGGGAGAGTT
CTTGAACGTTACCACACACTTACAACAGAA|ACAACAGAACTGGCCTTGTCCTCATGCTCA
CTTACAACAGAACCATGTTGAACGTTACCA|TCGGAGGACCCGATCAGAGAAGAAGGAACT
TGAAGGCACGGTTCGTACACCACTTAACAT|GTTACCACACACTTACAACAGAACCGGGAG
AACGTTACCACACACTTACAACAGAACACT|CGTTGGAACGGGTAGGGAGAGTTGAACGTT
AATTTCCCGTTATCAGTGGATAGCACCACC|CGCGGCTTACCCATCGTCCTAGTGCGCCCA
CTGCATGAAAAGCGTTGGAACGGGTAGGGA|ATAGCACCACCGGTTTGAACGTTACCACAC
GCCAAATTTCCCGTTATCAGTGGATAGCAC|AAGTCGCGGCTTACCCATCGTCCTAGTGCG
CACCACTTAACATTGCTGTGAATTCTAGCG|ACAGAACCGGGAGTCTCAAGAGCGCAGAGG
ACACACTTACAACAGAACGCCACGCGCGCG|TGTGCATGGCGTTGAACGTTACCACACACT
GCATGCTGACCGGGCGTCCACCCTGGTTCA|ACCACACACTTTGAACGTTACCACACACTT
TGAACGTTACCACACACTTACAACAGAACG|ATAGGGCCCAATGTGCATGGCGTTGAACGT
GAACGTTACCACACACTTACAACAGAACTG|CTTGAACGTTACCACACACTTACAACAGAA
TGCATGGCGTTGAACGTTACCACACACTTA|TTACAACAGAACACTTATGTGCCCTTGTTT
TCATCTATGCAGGTCCAATAGTTAACTTTA|TCCAGACGACTGATAAGTGGCCAGTGAGCC
CGCACCACCGACTCACCGCACGCTCAGACT|TGACCGGGCGTCCACCCTGGTTCAGAAGAT
GTCCTCATGCTCATCTATGCAGGTCCAATA|TCATAATAAGTCCAGACGACTGATAAGTGG
TTCGAGTAACGTTGAACGTTACCACACACT|GATCTACAATAAGCTTGAACGTTACCACAC
TGGCCAGTGAGCCACCATGATTCTTCTACA|GGCTCATCGAATAAGTACTACAGGTTTCAA
CACACTTACAACAGAACAGCGACGATAACG|TAACGCTTGTCTCGCTGGGCGCACCACCGA
ACCACACACTTACAACAGAACTCGGTCATA|CCCGAGCACGAGTTAACCAGATATCTTTCG
ACAGAACTGGCCTTGTCCTCATGCTCATCT|ACAACAGAACTCGGTCATAATAAGTCCAGA
TGATAAGTGGCCAGTGAGCCACCATGATTC|CTAATAAGGCTCATCGAATAAGTACTACAG
TTACAACAGAACGCCACGCGCGCGGTAGTT|TGGCGTTGAACGTTACCACACACTTACAAC
ACTTACAACAGAACCATGTTGAACGTTACC|TTCGGAGGACCCGATCAGAGAAGAAGGAAC
ACAGAACTCGGTCATAATAAGTCCAGACGA|AACCAGATATCTTTCGCAAACGATGCACAT
CTAGAACCTTCCGTCGGGGAACTCCTTGTC|TTCTACAGTGATTTGAACGTTACCACACAC
CCTTGTTTCACGGTGACGGGGTTCCTTCAC|ACTTACAACAGAACAGCGACGATAACGATC
TTACAACAGAACTACAACAGAACCTCAGGA|CGTAACATTTCGAGTAACGTTGAACGTTAC
TTACAACAGAACTGGCCTTGTCCTCATGCT|CACTTACAACAGAACTCGGTCATAATAAGT
GGATCCGTCCTGCCCGAGCACGAGTTAACC|AGGTGAAGGACTCGAACTCTCTTAAGAGAA
CCTGCATGAAAAGCGTTGGAACGGGTAGGG|GATAGCACCACCGGTTTGAACGTTACCACA
TTACAACAGAACGCTTGTTCGGAGGACCCG|CCTCATGCTCATCTATGCAGGTCCAATAGT
GCCACCATGATTCTTCTACAGTGATTTGAA|ATAAGTACTACAGGTTTCAACGGTGGTGAG
CCACACACTTACAACAGAACGGTAACGCTT|TTTCAGGTTCTGGGGATCCCGGCATAAACG
AGGACCCGATCAGAGAAGAAGGAACTTTAT|CCAATAGTTAACTTTATCTAATGTACCTAG
AACACTTATGTGCCCTTGTTTCACGGTGAC|AACGTTACCACACACTTACAACAGAACAGC
TTAGACAGGGTCGTCCGAAGCTGATGGGCC|CCGCACGCTCAGACTGAGACGCTTGGTAAG
ACTAGTCCACACCAGCGTTTGAACGTTACC|TGAACGTTACCACACACTTACAACAGAACG
TTGGCAGTGAAGGCACGGTTCGTACACCAC|ATTGAACGTTACCACACACTTACAACAGAA
CAACAGAACTCGGTCATAATAAGTCCAGAC|TTAACCAGATATCTTTCGCAAACGATGCAC
ACAACAGAACGCTTGTTCGGAGGACCCGAT|TCATGCTCATCTATGCAGGTCCAATAGTTA
GTCGGGGAACTCCTTGTCGCGATCTACAAT|TTGAACGTTACCACACACTTACAACAGAAC
CCACACACTTACAACAGAACTCGGTCATAA|CCGAGCACGAGTTAACCAGATATCTTTCGC
GGCTTACCCATCGTCCTAGTGCGCCCAAAT|ACACTTACAACAGAACTAGTCCACACCAGC
GTTATCAGTGGATAGCACCACCGGTTTGAA|ACCCATCGTCCTAGTGCGCCCAAATTGAAT
CTCACCGCACGCTCAGACTGAGACGCTTGG|CCACCCTGGTTCAGAAGATCTAGCTTGAAC
GATAACGATCCTTAGACAGGGTCGTCCGAA|CCACCGACTCACCGCACGCTCAGACTGAGA
CAATGTGCATGGCGTTGAACGTTACCACAC|CACACTTACAACAGAACACTTATGTGCCCT
GGACCCGATCAGAGAAGAAGGAACTTTATG|CAATAGTTAACTTTATCTAATGTACCTAGA
AACGATCCTTAGACAGGGTCGTCCGAAGCT|CCGACTCACCGCACGCTCAGACTGAGACGC
GCGGTAGTTTCCTCCCATTGGCAGTGAAGG|ACTTACAACAGAACTCTATTGAACGTTACC
TCTTCTACAGTGATTTGAACGTTACCACAC|AGGTTTCAACGGTGGTGAGAAAACTCTGGT
TACACCACTTAACATTGCTGTGAATTCTAG|CAACAGAACCGGGAGTCTCAAGAGCGCAGA
TGGTTCGAACTAAACCTGCATGAAAAGCGT|TCCCGTTATCAGTGGATAGCACCACCGGTT
ATAGCACCACCGGTTTGAACGTTACCACAC|TAGTGCGCCCAAATTGAATAGGTGTTTCAG
CAGAACCGGGAGTCTCAAGAGCGCAGAGGA|CACACACTTACAACAGAACTGTGGTTCGAA
ACACCAGCGTTTGAACGTTACCACACACTT|ACCACACACTTACAACAGAACGCTTGTTCG
AGACGACTGATAAGTGGCCAGTGAGCCACC|GCACATTCTAATAAGGCTCATCGAATAAGT
AGAACGCTTGTTCGGAGGACCCGATCAGAG|CTCATCTATGCAGGTCCAATAGTTAACTTT
CGTTGAACGTTACCACACACTTACAACAGA|AGAACACTTATGTGCCCTTGTTTCACGGTG
GCTTGTTCGGAGGACCCGATCAGAGAAGAA|CTATGCAGGTCCAATAGTTAACTTTATCTA
CAGAACTAGTCCACACCAGCGTTTGAACGT|CGCTTGAACGTTACCACACACTTACAACAG
TACAACAGAACTCGGTCATAATAAGTCCAG|AGTTAACCAGATATCTTTCGCAAACGATGC
GAGCATGCTGACCGGGCGTCCACCCTGGTT|TTACCACACACTTTGAACGTTACCACACAC
TTGAACGTTACCACACACTTACAACAGAAC|AACACTTATGTGCCCTTGTTTCACGGTGAC
GTCCACACCAGCGTTTGAACGTTACCACAC|CGTTACCACACACTTACAACAGAACGCTTG
CACACTTTGAACGTTACCACACACTTACAA|TTATGGTAAACACGACTGGTCGAACGTAAC
ACCACACACTTACAACAGAACCATGTTGAA|ACGCTTGTTCGGAGGACCCGATCAGAGAAG
TTACAACAGAACACTTATGTGCCCTTGTTT|GGAGAGTTGAACGTTACCACACACTTACAA
GCTATTGTTGAACGTTACCACACACTTACA|GCATGAAAAGCGTTGGAACGGGTAGGGAGA
CACACTTACAACAGAACTCTATTGAACGTT|CCTTGTTTCACGGTGACGGGGTTCCTTCAC
GCGCACCGACATCCAGGCTGATACATAGGG|AGGACCAACCAGGCTATTGTTGAACGTTAC
CACTTACAACAGAACTCGGTCATAATAAGT|CACGAGTTAACCAGATATCTTTCGCAAACG
CACACTTACAACAGAACGCTTGTTCGGAGG|CTTGTCCTCATGCTCATCTATGCAGGTCCA
ACTGATAAGTGGCCAGTGAGCCACCATGAT|TTCTAATAAGGCTCATCGAATAAGTACTAC
ACACTTACAACAGAACTGTGGTTCGAACTA|AAGCTGATGGGCCAAATTTCCCGTTATCAG
CAACAGAACTGTGGTTCGAACTAAACCTGC|TGGGCCAAATTTCCCGTTATCAGTGGATAG
TACAACAGAACCTCAGGAACCGAGACGCTT|AGTAACGTTGAACGTTACCACACACTTACA
AATTGAATAGGTGTTTCAGGTTCTGGGGAT|AGCGTTTGAACGTTACCACACACTTACAAC
GACTGGTCGAACGTAACATTTCGAGTAACG|TCGGGGAACTCCTTGTCGCGATCTACAATA
ACGTTACCACACACTTACAACAGAACCGGG|TTCACAGAATTGAACGTTACCACACACTTA
TGTTCGGAGGACCCGATCAGAGAAGAAGGA|TGCAGGTCCAATAGTTAACTTTATCTAATG
CAGACTGAGACGCTTGGTAAGTCGCGGCTT|GAAGATCTAGCTTGAACGTTACCACACACT
TAGGGAGAGTTGAACGTTACCACACACTTA|CCACACACTTACAACAGAACGGTAACGCTT
TGGCGTTGAACGTTACCACACACTTACAAC|AACAGAACACTTATGTGCCCTTGTTTCACG
GCTGTGAATTCTAGCGCACCGACATCCAGG|CTCAAGAGCGCAGAGGACCAACCAGGCTAT
GCGTCCACCCTGGTTCAGAAGATCTAGCTT|AACGTTACCACACACTTACAACAGAACTAC
AGAGAAGAAGGAACTTTATGGTAAACACGA|CTTTATCTAATGTACCTAGAACCTTCCGTC
GCGTTGAACGTTACCACACACTTACAACAG|CAGAACACTTATGTGCCCTTGTTTCACGGT
TAAGTGGCCAGTGAGCCACCATGATTCTTC|ATAAGGCTCATCGAATAAGTACTACAGGTT
ATCAGAGAAGAAGGAACTTTATGGTAAACA|TAACTTTATCTAATGTACCTAGAACCTTCC
AGAGGACCAACCAGGCTATTGTTGAACGTT|TTCGAACTAAACCTGCATGAAAAGCGTTGG
TTGTCTCGCTGGGCGCACCACCGACTCACC|CGGGAGAGCATGCTGACCGGGCGTCCACCC
AACAGAACGGGATCCGTCCTGCCCGAGCAC|CAGATACGGAGGTGAAGGACTCGAACTCTC
GCCCAAATTGAATAGGTGTTTCAGGTTCTG|ACACCAGCGTTTGAACGTTACCACACACTT
GTTGAACGTTACCACACACTTTGAACGTTA|GAGAAGAAGGAACTTTATGGTAAACACGAC
ACGTTGAACGTTACCACACACTTACAACAG|ATAAGCTTGAACGTTACCACACACTTACAA
CGACGATAACGATCCTTAGACAGGGTCGTC|CGCACCACCGACTCACCGCACGCTCAGACT
GCGGCTTACCCATCGTCCTAGTGCGCCCAA|ACACACTTACAACAGAACTAGTCCACACCA
CGTTACCACACACTTACAACAGAACGGGAT|AAAACTCTGGTTTATCTCAGATACGGAGGT
CCACCATGATTCTTCTACAGTGATTTGAAC|TAAGTACTACAGGTTTCAACGGTGGTGAGA
GTGAAGGCACGGTTCGTACACCACTTAACA|CGTTACCACACACTTACAACAGAACCGGGA
TTCGAACTAAACCTGCATGAAAAGCGTTGG|CGTTATCAGTGGATAGCACCACCGGTTTGA
AGAACCGGGAGTCTCAAGAGCGCAGAGGAC|ACACACTTACAACAGAACTGTGGTTCGAAC
AACTACAACAGAACCTCAGGAACCGAGACG|TCGAGTAACGTTGAACGTTACCACACACTT
ACTTACAACAGAACGCTTGTTCGGAGGACC|GTCCTCATGCTCATCTATGCAGGTCCAATA
TGATTCTTCTACAGTGATTTGAACGTTACC|CTACAGGTTTCAACGGTGGTGAGAAAACTC
TCCTGCCCGAGCACGAGTTAACCAGATATC|GGACTCGAACTCTCTTAAGAGAACTGAATG
CTTACAACAGAACACTTATGTGCCCTTGTT|GGGAGAGTTGAACGTTACCACACACTTACA
CACTTACAACAGAACTGGCCTTGTCCTCAT|ACACACTTACAACAGAACTCGGTCATAATA
ACACACTTACAACAGAACCATGTTGAACGT|CTTGTTCGGAGGACCCGATCAGAGAAGAAG
TACAACAGAACTGGCCTTGTCCTCATGCTC|ACTTACAACAGAACTCGGTCATAATAAGTC
CTTCTACAGTGATTTGAACGTTACCACACA|GGTTTCAACGGTGGTGAGAAAACTCTGGTT
AGTAACGTTGAACGTTACCACACACTTACA|TACAATAAGCTTGAACGTTACCACACACTT
GAGACGCTTGAACGTTACCACACACTTACA|ACACTTACAACAGAACTGGCCTTGTCCTCA
CAGCGACGATAACGATCCTTAGACAGGGTC|GGGCGCACCACCGACTCACCGCACGCTCAG
CAGTGAGCCACCATGATTCTTCTACAGTGA|CATCGAATAAGTACTACAGGTTTCAACGGT
CCATGTTGAACGTTACCACACACTTTGAAC|ATCAGAGAAGAAGGAACTTTATGGTAAACA
CTCATGCTCATCTATGCAGGTCCAATAGTT|TAATAAGTCCAGACGACTGATAAGTGGCCA
CGCTGGGCGCACCACCGACTCACCGCACGC|AGCATGCTGACCGGGCGTCCACCCTGGTTC
GAACGGGTAGGGAGAGTTGAACGTTACCAC|AACGTTACCACACACTTACAACAGAACGGT
CACTTACAACAGAACTGTGGTTCGAACTAA|AGCTGATGGGCCAAATTTCCCGTTATCAGT
TTTCGAGTAACGTTGAACGTTACCACACAC|CGATCTACAATAAGCTTGAACGTTACCACA
GGTTCGAACTAAACCTGCATGAAAAGCGTT|CCCGTTATCAGTGGATAGCACCACCGGTTT
CCCATTGGCAGTGAAGGCACGGTTCGTACA|CTCTATTGAACGTTACCACACACTTACAAC
AACGTTACCACACACTTACAACAGAACGCC|AGGGCCCAATGTGCATGGCGTTGAACGTTA
TGTCTCGCTGGGCGCACCACCGACTCACCG|GGGAGAGCATGCTGACCGGGCGTCCACCCT
TAGTCCACACCAGCGTTTGAACGTTACCAC|AACGTTACCACACACTTACAACAGAACGCT
ACCACACACTTACAACAGAACGGTAACGCT|GTTTCAGGTTCTGGGGATCCCGGCATAAAC
AGAGCATGCTGACCGGGCGTCCACCCTGGT|GTTACCACACACTTTGAACGTTACCACACA
TTTATCTAATGTACCTAGAACCTTCCGTCG|AGCCACCATGATTCTTCTACAGTGATTTGA
ACAACAGAACAGCGACGATAACGATCCTTA|TGTCTCGCTGGGCGCACCACCGACTCACCG
AGTCCAGACGACTGATAAGTGGCCAGTGAG|ACGATGCACATTCTAATAAGGCTCATCGAA
TACCACACACTTACAACAGAACAGCGACGA|AACGGTAACGCTTGTCTCGCTGGGCGCACC
GACCGGGCGTCCACCCTGGTTCAGAAGATC|ACTTTGAACGTTACCACACACTTACAACAG
TCGTACACCACTTAACATTGCTGTGAATTC|TTACAACAGAACCGGGAGTCTCAAGAGCGC
CTTACAACAGAACTGTGGTTCGAACTAAAC|CTGATGGGCCAAATTTCCCGTTATCAGTGG
TGTTGAACGTTACCACACACTTTGAACGTT|AGAGAAGAAGGAACTTTATGGTAAACACGA
ACTGGCCTTGTCCTCATGCTCATCTATGCA|AGAACTCGGTCATAATAAGTCCAGACGACT
AACTGTGGTTCGAACTAAACCTGCATGAAA|AAATTTCCCGTTATCAGTGGATAGCACCAC
ACCTAGAACCTTCCGTCGGGGAACTCCTTG|TCTTCTACAGTGATTTGAACGTTACCACAC
GAACGTTACCACACACTTACAACAGAACCA|CAACAGAACGCTTGTTCGGAGGACCCGATC
TTACCACACACTTACAACAGAACCATGTTG|GAACGCTTGTTCGGAGGACCCGATCAGAGA
ACGGTGACGGGGTTCCTTCACAGAATTGAA|AGAACAGCGACGATAACGATCCTTAGACAG
ATGGCGTTGAACGTTACCACACACTTACAA|CAACAGAACACTTATGTGCCCTTGTTTCAC
GGATAGCACCACCGGTTTGAACGTTACCAC|CCTAGTGCGCCCAAATTGAATAGGTGTTTC
CGGTGACGGGGTTCCTTCACAGAATTGAAC|GAACAGCGACGATAACGATCCTTAGACAGG
ATAAGTCCAGACGACTGATAAGTGGCCAGT|CAAACGATGCACATTCTAATAAGGCTCATC
TTACAACAGAACAGCGACGATAACGATCCT|CTTGTCTCGCTGGGCGCACCACCGACTCAC
TCCCGTTATCAGTGGATAGCACCACCGGTT|GCTTACCCATCGTCCTAGTGCGCCCAAATT
CATCGTCCTAGTGCGCCCAAATTGAATAGG|AACAGAACTAGTCCACACCAGCGTTTGAAC
GAATTGAACGTTACCACACACTTACAACAG|TTAGACAGGGTCGTCCGAAGCTGATGGGCC
GGTAACGCTTGTCTCGCTGGGCGCACCACC|GGCATAAACGGGAGAGCATGCTGACCGGGC
GTGAATTCTAGCGCACCGACATCCAGGCTG|AAGAGCGCAGAGGACCAACCAGGCTATTGT
ACAGAACTGTGGTTCGAACTAAACCTGCAT|GGCCAAATTTCCCGTTATCAGTGGATAGCA
CCACACACTTACAACAGAACGGGATCCGTC|TCTGGTTTATCTCAGATACGGAGGTGAAGG
CGATCTACAATAAGCTTGAACGTTACCACA|TACAACAGAACGGGATCCGTCCTGCCCGAG
CGCAGAGGACCAACCAGGCTATTGTTGAAC|TGGTTCGAACTAAACCTGCATGAAAAGCGT
TCCAGGCTGATACATAGGGCCCAATGTGCA|GGCTATTGTTGAACGTTACCACACACTTAC
AAGTGGCCAGTGAGCCACCATGATTCTTCT|TAAGGCTCATCGAATAAGTACTACAGGTTT
CACTTACAACAGAACGCCACGCGCGCGGTA|GCATGGCGTTGAACGTTACCACACACTTAC
GGCCAAATTTCCCGTTATCAGTGGATAGCA|TAAGTCGCGGCTTACCCATCGTCCTAGTGC
AGATCTAGCTTGAACGTTACCACACACTTA|AACAGAACTACAACAGAACCTCAGGAACCG
AACAGAACTGGCCTTGTCCTCATGCTCATC|TACAACAGAACTCGGTCATAATAAGTCCAG
ACACTTACAACAGAACTACAACAGAACCTC|CGAACGTAACATTTCGAGTAACGTTGAACG
ACTTACAACAGAACTGGCCTTGTCCTCATG|CACACTTACAACAGAACTCGGTCATAATAA
TTACCACACACTTACAACAGAACTACAACA|GACTGGTCGAACGTAACATTTCGAGTAACG
CTTGTTTCACGGTGACGGGGTTCCTTCACA|CTTACAACAGAACAGCGACGATAACGATCC
GATGGGCCAAATTTCCCGTTATCAGTGGAT|TTGGTAAGTCGCGGCTTACCCATCGTCCTA
TTTCCCGTTATCAGTGGATAGCACCACCGG|CGGCTTACCCATCGTCCTAGTGCGCCCAAA
TGCCCGAGCACGAGTTAACCAGATATCTTT|CTCGAACTCTCTTAAGAGAACTGAATGTAA
GCGACGATAACGATCCTTAGACAGGGTCGT|GCGCACCACCGACTCACCGCACGCTCAGAC
TGGGGATCCCGGCATAAACGGGAGAGCATG|TTACAACAGAACCATGTTGAACGTTACCAC
GCGCGCGGTAGTTTCCTCCCATTGGCAGTG|ACACACTTACAACAGAACTCTATTGAACGT
AACTCCTTGTCGCGATCTACAATAAGCTTG|TTACCACACACTTACAACAGAACGGGATCC
GAGTTGAACGTTACCACACACTTACAACAG|ACTTACAACAGAACGGTAACGCTTGTCTCG
CGCTTGTTCGGAGGACCCGATCAGAGAAGA|TCTATGCAGGTCCAATAGTTAACTTTATCT
ACACCACTTAACATTGCTGTGAATTCTAGC|AACAGAACCGGGAGTCTCAAGAGCGCAGAG
GGACCAACCAGGCTATTGTTGAACGTTACC|GAACTAAACCTGCATGAAAAGCGTTGGAAC
GCTGACCGGGCGTCCACCCTGGTTCAGAAG|CACACTTTGAACGTTACCACACACTTACAA
AACTCTATTGAACGTTACCACACACTTACA|GACGGGGTTCCTTCACAGAATTGAACGTTA
CAACAGAACGGTAACGCTTGTCTCGCTGGG|GGGGATCCCGGCATAAACGGGAGAGCATGC
ACACTTACAACAGAACACTTATGTGCCCTT|GTAGGGAGAGTTGAACGTTACCACACACTT
TGAACGTTACCACACACTTACAACAGAACG|TGAGAAAACTCTGGTTTATCTCAGATACGG
CAACAGAACCGGGAGTCTCAAGAGCGCAGA|TACCACACACTTACAACAGAACTGTGGTTC
TTCCCGTTATCAGTGGATAGCACCACCGGT|GGCTTACCCATCGTCCTAGTGCGCCCAAAT
ACACTTACAACAGAACTGGCCTTGTCCTCA|CACACACTTACAACAGAACTCGGTCATAAT
GTGACGGGGTTCCTTCACAGAATTGAACGT|ACAGCGACGATAACGATCCTTAGACAGGGT
ATCCTTAGACAGGGTCGTCCGAAGCTGATG|CTCACCGCACGCTCAGACTGAGACGCTTGG
CTTCCGTCGGGGAACTCCTTGTCGCGATCT|GTGATTTGAACGTTACCACACACTTACAAC
TTCTGGGGATCCCGGCATAAACGGGAGAGC|CACTTACAACAGAACCATGTTGAACGTTAC
AACAGAACGCTTGTTCGGAGGACCCGATCA|ATGCTCATCTATGCAGGTCCAATAGTTAAC
ACAACAGAACCGGGAGTCTCAAGAGCGCAG|TTACCACACACTTACAACAGAACTGTGGTT
GAGGACCAACCAGGCTATTGTTGAACGTTA|TCGAACTAAACCTGCATGAAAAGCGTTGGA
TCCAGACGACTGATAAGTGGCCAGTGAGCC|GATGCACATTCTAATAAGGCTCATCGAATA
CCTTAGACAGGGTCGTCCGAAGCTGATGGG|CACCGCACGCTCAGACTGAGACGCTTGGTA
TTCGTACACCACTTAACATTGCTGTGAATT|CTTACAACAGAACCGGGAGTCTCAAGAGCG
CACTTACAACAGAACCGGGAGTCTCAAGAG|GAACGTTACCACACACTTACAACAGAACTG
TCACAGAATTGAACGTTACCACACACTTAC|GATCCTTAGACAGGGTCGTCCGAAGCTGAT
AACTGGCCTTGTCCTCATGCTCATCTATGC|CAGAACTCGGTCATAATAAGTCCAGACGAC
GGTTCTGGGGATCCCGGCATAAACGGGAGA|CACACTTACAACAGAACCATGTTGAACGTT
AACCTGCATGAAAAGCGTTGGAACGGGTAG|TGGATAGCACCACCGGTTTGAACGTTACCA
CCACACACTTACAACAGAACTGGCCTTGTC|TTACCACACACTTACAACAGAACTCGGTCA
GAGCACGAGTTAACCAGATATCTTTCGCAA|ACTCTCTTAAGAGAACTGAATGTAACTCCA
AGCGCAGAGGACCAACCAGGCTATTGTTGA|TGTGGTTCGAACTAAACCTGCATGAAAAGC
CACGAGTTAACCAGATATCTTTCGCAAACG|CTCTTAAGAGAACTGAATGTAACTCCAACG
AATAGTTAACTTTATCTAATGTACCTAGAA|GTGGCCAGTGAGCCACCATGATTCTTCTAC
CCAACCAGGCTATTGTTGAACGTTACCACA|CTAAACCTGCATGAAAAGCGTTGGAACGGG
TCCGTCCTGCCCGAGCACGAGTTAACCAGA|TGAAGGACTCGAACTCTCTTAAGAGAACTG
GGGAGAGCATGCTGACCGGGCGTCCACCCT|AACGTTACCACACACTTTGAACGTTACCAC
GTCTTGAACGTTACCACACACTTACAACAG|ATACATAGGGCCCAATGTGCATGGCGTTGA
TTAACATTGCTGTGAATTCTAGCGCACCGA|CCGGGAGTCTCAAGAGCGCAGAGGACCAAC
ACCAACCAGGCTATTGTTGAACGTTACCAC|ACTAAACCTGCATGAAAAGCGTTGGAACGG
CCACACACTTACAACAGAACAGCGACGATA|CGGTAACGCTTGTCTCGCTGGGCGCACCAC
CGTTACCACACACTTACAACAGAACACTTA|TTGGAACGGGTAGGGAGAGTTGAACGTTAC
ACACACTTACAACAGAACACTTATGTGCCC|GGGTAGGGAGAGTTGAACGTTACCACACAC
ACCTTCCGTCGGGGAACTCCTTGTCGCGAT|CAGTGATTTGAACGTTACCACACACTTACA
GGCACGGTTCGTACACCACTTAACATTGCT|CCACACACTTACAACAGAACCGGGAGTCTC
CGCGGTAGTTTCCTCCCATTGGCAGTGAAG|CACTTACAACAGAACTCTATTGAACGTTAC
ACTTACAACAGAACGCCACGCGCGCGGTAG|CATGGCGTTGAACGTTACCACACACTTACA
CAGTGAAGGCACGGTTCGTACACCACTTAA|AACGTTACCACACACTTACAACAGAACCGG
CTGAGACGCTTGGTAAGTCGCGGCTTACCC|ATCTAGCTTGAACGTTACCACACACTTACA
CAACAGAACGCCACGCGCGCGGTAGTTTCC|CGTTGAACGTTACCACACACTTACAACAGA
CGCACCGACATCCAGGCTGATACATAGGGC|GGACCAACCAGGCTATTGTTGAACGTTACC
CCACACACTTACAACAGAACACTTATGTGC|ACGGGTAGGGAGAGTTGAACGTTACCACAC
CCACCCTGGTTCAGAAGATCTAGCTTGAAC|TTACCACACACTTACAACAGAACTACAACA
TAAGCTTGAACGTTACCACACACTTACAAC|CGGGATCCGTCCTGCCCGAGCACGAGTTAA
CGGCTTACCCATCGTCCTAGTGCGCCCAAA|CACACTTACAACAGAACTAGTCCACACCAG
ACCACCGGTTTGAACGTTACCACACACTTA|CGCCCAAATTGAATAGGTGTTTCAGGTTCT
CAGAACACTTATGTGCCCTTGTTTCACGGT|TTGAACGTTACCACACACTTACAACAGAAC
GGGCGCACCACCGACTCACCGCACGCTCAG|TGCTGACCGGGCGTCCACCCTGGTTCAGAA
CACACACTTACAACAGAACTCGGTCATAAT|CGAGCACGAGTTAACCAGATATCTTTCGCA
TACCACACACTTACAACAGAACTACAACAG|ACTGGTCGAACGTAACATTTCGAGTAACGT
CCGAGCACGAGTTAACCAGATATCTTTCGC|GAACTCTCTTAAGAGAACTGAATGTAACTC
CATTGGCAGTGAAGGCACGGTTCGTACACC|CTATTGAACGTTACCACACACTTACAACAG
ACTCCTTGTCGCGATCTACAATAAGCTTGA|TACCACACACTTACAACAGAACGGGATCCG
CACACTTACAACAGAACTGTGGTTCGAACT|GAAGCTGATGGGCCAAATTTCCCGTTATCA
CAGAACCTCAGGAACCGAGACGCTTGAACG|CGTTGAACGTTACCACACACTTACAACAGA
GGTTCAGAAGATCTAGCTTGAACGTTACCA|ACACTTACAACAGAACTACAACAGAACCTC
GTTACCACACACTTACAACAGAACGGGATC|AAACTCTGGTTTATCTCAGATACGGAGGTG
TTACCACACACTTACAACAGAACGCTTGTT|ACTGGCCTTGTCCTCATGCTCATCTATGCA
ACACTTACAACAGAACGGGATCCGTCCTGC|GTTTATCTCAGATACGGAGGTGAAGGACTC
CACGGTGACGGGGTTCCTTCACAGAATTGA|CAGAACAGCGACGATAACGATCCTTAGACA
ACACTTACAACAGAACGCCACGCGCGCGGT|TGCATGGCGTTGAACGTTACCACACACTTA
ACACACTTACAACAGAACAGCGACGATAAC|GTAACGCTTGTCTCGCTGGGCGCACCACCG
CCGAAGCTGATGGGCCAAATTTCCCGTTAT|TGAGACGCTTGGTAAGTCGCGGCTTACCCA
GAATTCTAGCGCACCGACATCCAGGCTGAT|GAGCGCAGAGGACCAACCAGGCTATTGTTG
TCAGGAACCGAGACGCTTGAACGTTACCAC|CGTTACCACACACTTACAACAGAACTGGCC
TCAGAGAAGAAGGAACTTTATGGTAAACAC|AACTTTATCTAATGTACCTAGAACCTTCCG
TGTCCTCATGCTCATCTATGCAGGTCCAAT|GTCATAATAAGTCCAGACGACTGATAAGTG
GTGAGCCACCATGATTCTTCTACAGTGATT|TCGAATAAGTACTACAGGTTTCAACGGTGG
TCTAATGTACCTAGAACCTTCCGTCGGGGA|ACCATGATTCTTCTACAGTGATTTGAACGT
AGAACGGGATCCGTCCTGCCCGAGCACGAG|ATACGGAGGTGAAGGACTCGAACTCTCTTA
CGCTCAGACTGAGACGCTTGGTAAGTCGCG|TTCAGAAGATCTAGCTTGAACGTTACCACA
TTGTTGAACGTTACCACACACTTACAACAG|GAAAAGCGTTGGAACGGGTAGGGAGAGTTG
TCTACAGTGATTTGAACGTTACCACACACT|TTTCAACGGTGGTGAGAAAACTCTGGTTTA
GAACGGGATCCGTCCTGCCCGAGCACGAGT|TACGGAGGTGAAGGACTCGAACTCTCTTAA
GTTACCACACACTTACAACAGAACTGGCCT|AACGTTACCACACACTTACAACAGAACTCG
GCCTTGTCCTCATGCTCATCTATGCAGGTC|CTCGGTCATAATAAGTCCAGACGACTGATA
ACTTACAACAGAACAGCGACGATAACGATC|CGCTTGTCTCGCTGGGCGCACCACCGACTC
GGAACCGAGACGCTTGAACGTTACCACACA|TACCACACACTTACAACAGAACTGGCCTTG
CGTTACCACACACTTACAACAGAACCATGT|CAGAACGCTTGTTCGGAGGACCCGATCAGA
TGTTTCAGGTTCTGGGGATCCCGGCATAAA|GTTACCACACACTTACAACAGAACCATGTT
TGAACGTTACCACACACTTACAACAGAACC|ACAACAGAACGCTTGTTCGGAGGACCCGAT
CACTTATGTGCCCTTGTTTCACGGTGACGG|CGTTACCACACACTTACAACAGAACAGCGA
CCAGGCTATTGTTGAACGTTACCACACACT|ACCTGCATGAAAAGCGTTGGAACGGGTAGG
ACAGAACGGGATCCGTCCTGCCCGAGCACG|AGATACGGAGGTGAAGGACTCGAACTCTCT
GAACGTTACCACACACTTTGAACGTTACCA|AAGAAGGAACTTTATGGTAAACACGACTGG
TTACAACAGAACGGGATCCGTCCTGCCCGA|ATCTCAGATACGGAGGTGAAGGACTCGAAC
AACAGAACAGCGACGATAACGATCCTTAGA|TCTCGCTGGGCGCACCACCGACTCACCGCA
TGAGACGCTTGGTAAGTCGCGGCTTACCCA|TCTAGCTTGAACGTTACCACACACTTACAA
CGTTACCACACACTTACAACAGAACAGCGA|CAGAACGGTAACGCTTGTCTCGCTGGGCGC
TTCCTCCCATTGGCAGTGAAGGCACGGTTC|CAGAACTCTATTGAACGTTACCACACACTT
TATTGAACGTTACCACACACTTACAACAGA|GGTTCCTTCACAGAATTGAACGTTACCACA
GAAGGCACGGTTCGTACACCACTTAACATT|TTACCACACACTTACAACAGAACCGGGAGT
ACCACACACTTACAACAGAACTACAACAGA|CTGGTCGAACGTAACATTTCGAGTAACGTT
ACCCGATCAGAGAAGAAGGAACTTTATGGT|ATAGTTAACTTTATCTAATGTACCTAGAAC
ATGCTGACCGGGCGTCCACCCTGGTTCAGA|CACACACTTTGAACGTTACCACACACTTAC
TGAACGTTACCACACACTTACAACAGAACT|CAACAGAACCTCAGGAACCGAGACGCTTGA
CTTAGACAGGGTCGTCCGAAGCTGATGGGC|ACCGCACGCTCAGACTGAGACGCTTGGTAA
CACCAGCGTTTGAACGTTACCACACACTTA|CCACACACTTACAACAGAACGCTTGTTCGG
GACATCCAGGCTGATACATAGGGCCCAATG|ACCAGGCTATTGTTGAACGTTACCACACAC
TTACAACAGAACTCTATTGAACGTTACCAC|TTTCACGGTGACGGGGTTCCTTCACAGAAT
CTCGCTGGGCGCACCACCGACTCACCGCAC|AGAGCATGCTGACCGGGCGTCCACCCTGGT
TTTCCTCCCATTGGCAGTGAAGGCACGGTT|ACAGAACTCTATTGAACGTTACCACACACT
ACGTTACCACACACTTACAACAGAACCATG|ACAGAACGCTTGTTCGGAGGACCCGATCAG
ATTTGAACGTTACCACACACTTACAACAGA|TGGTGAGAAAACTCTGGTTTATCTCAGATA
CATCCAGGCTGATACATAGGGCCCAATGTG|CAGGCTATTGTTGAACGTTACCACACACTT
AACAGAACCGGGAGTCTCAAGAGCGCAGAG|ACCACACACTTACAACAGAACTGTGGTTCG
TAACTTTATCTAATGTACCTAGAACCTTCC|AGTGAGCCACCATGATTCTTCTACAGTGAT
ATTCTTCTACAGTGATTTGAACGTTACCAC|ACAGGTTTCAACGGTGGTGAGAAAACTCTG
CTTGTTCGGAGGACCCGATCAGAGAAGAAG|TATGCAGGTCCAATAGTTAACTTTATCTAA
AACGTTACCACACACTTACAACAGAACTCT|ACTTATGTGCCCTTGTTTCACGGTGACGGG
ACGGGGTTCCTTCACAGAATTGAACGTTAC|GCGACGATAACGATCCTTAGACAGGGTCGT
CAACAGAACTCTATTGAACGTTACCACACA|CACGGTGACGGGGTTCCTTCACAGAATTGA
CTACAGTGATTTGAACGTTACCACACACTT|TTCAACGGTGGTGAGAAAACTCTGGTTTAT
AGGCTGATACATAGGGCCCAATGTGCATGG|TATTGTTGAACGTTACCACACACTTACAAC
ACCACACACTTACAACAGAACAGCGACGAT|ACGGTAACGCTTGTCTCGCTGGGCGCACCA
AACTTTATCTAATGTACCTAGAACCTTCCG|GTGAGCCACCATGATTCTTCTACAGTGATT
GGAACTTTATGGTAAACACGACTGGTCGAA|ATGTACCTAGAACCTTCCGTCGGGGAACTC
ACGGGTAGGGAGAGTTGAACGTTACCACAC|CGTTACCACACACTTACAACAGAACGGTAA
GTCCACCCTGGTTCAGAAGATCTAGCTTGA|CGTTACCACACACTTACAACAGAACTACAA
ACGTTACCACACACTTACAACAGAACACTT|GTTGGAACGGGTAGGGAGAGTTGAACGTTA
AACAGAACTACAACAGAACCTCAGGAACCG|ACATTTCGAGTAACGTTGAACGTTACCACA
CTTGAACGTTACCACACACTTACAACAGAA|TACAACAGAACCTCAGGAACCGAGACGCTT
ACAACAGAACTGTGGTTCGAACTAAACCTG|ATGGGCCAAATTTCCCGTTATCAGTGGATA
TCGCTGGGCGCACCACCGACTCACCGCACG|GAGCATGCTGACCGGGCGTCCACCCTGGTT
TTACCCATCGTCCTAGTGCGCCCAAATTGA|CTTACAACAGAACTAGTCCACACCAGCGTT
CAGGAACCGAGACGCTTGAACGTTACCACA|GTTACCACACACTTACAACAGAACTGGCCT
CCAGGCTGATACATAGGGCCCAATGTGCAT|GCTATTGTTGAACGTTACCACACACTTACA
ACACACTTACAACAGAACTAGTCCACACCA|CAGGAACCGAGACGCTTGAACGTTACCACA
ACCACACACTTACAACAGAACGGGATCCGT|CTCTGGTTTATCTCAGATACGGAGGTGAAG
ACACACTTACAACAGAACGCTTGTTCGGAG|CCTTGTCCTCATGCTCATCTATGCAGGTCC
ACGGTTCGTACACCACTTAACATTGCTGTG|CACACTTACAACAGAACCGGGAGTCTCAAG
TAAACACGACTGGTCGAACGTAACATTTCG|CCTTCCGTCGGGGAACTCCTTGTCGCGATC
TGGCCTTGTCCTCATGCTCATCTATGCAGG|AACTCGGTCATAATAAGTCCAGACGACTGA
AACGGGATCCGTCCTGCCCGAGCACGAGTT|ACGGAGGTGAAGGACTCGAACTCTCTTAAG
ACACGACTGGTCGAACGTAACATTTCGAGT|TCCGTCGGGGAACTCCTTGTCGCGATCTAC
AGCGTTGGAACGGGTAGGGAGAGTTGAACG|CGGTTTGAACGTTACCACACACTTACAACA
CACGCGCGCGGTAGTTTCCTCCCATTGGCA|ACCACACACTTACAACAGAACTCTATTGAA
CAAATTTCCCGTTATCAGTGGATAGCACCA|GTCGCGGCTTACCCATCGTCCTAGTGCGCC
CCGATCAGAGAAGAAGGAACTTTATGGTAA|AGTTAACTTTATCTAATGTACCTAGAACCT
TCCTCCCATTGGCAGTGAAGGCACGGTTCG|AGAACTCTATTGAACGTTACCACACACTTA
GAACTAGTCCACACCAGCGTTTGAACGTTA|CTTGAACGTTACCACACACTTACAACAGAA
GACTGATAAGTGGCCAGTGAGCCACCATGA|ATTCTAATAAGGCTCATCGAATAAGTACTA
CGGAGGACCCGATCAGAGAAGAAGGAACTT|GGTCCAATAGTTAACTTTATCTAATGTACC
ACCGGGCGTCCACCCTGGTTCAGAAGATCT|CTTTGAACGTTACCACACACTTACAACAGA
CGATCAGAGAAGAAGGAACTTTATGGTAAA|GTTAACTTTATCTAATGTACCTAGAACCTT
TACCACACACTTACAACAGAACCGGGAGTC|CAGAATTGAACGTTACCACACACTTACAAC
AGAACCTCAGGAACCGAGACGCTTGAACGT|GTTGAACGTTACCACACACTTACAACAGAA
AGAACTAGTCCACACCAGCGTTTGAACGTT|GCTTGAACGTTACCACACACTTACAACAGA
CATGAAAAGCGTTGGAACGGGTAGGGAGAG|GCACCACCGGTTTGAACGTTACCACACACT
CACGACTGGTCGAACGTAACATTTCGAGTA|CCGTCGGGGAACTCCTTGTCGCGATCTACA
TCCTTGTCGCGATCTACAATAAGCTTGAAC|CCACACACTTACAACAGAACGGGATCCGTC
AGTCTCAAGAGCGCAGAGGACCAACCAGGC|CAACAGAACTGTGGTTCGAACTAAACCTGC
TATGCAGGTCCAATAGTTAACTTTATCTAA|ACGACTGATAAGTGGCCAGTGAGCCACCAT
GCACCGACATCCAGGCTGATACATAGGGCC|GACCAACCAGGCTATTGTTGAACGTTACCA
ACACTTACAACAGAACTCTATTGAACGTTA|CTTGTTTCACGGTGACGGGGTTCCTTCACA
TACCACACACTTACAACAGAACGCCACGCG|CCAATGTGCATGGCGTTGAACGTTACCACA
CGCTTGTCTCGCTGGGCGCACCACCGACTC|AAACGGGAGAGCATGCTGACCGGGCGTCCA
TTGTTCGGAGGACCCGATCAGAGAAGAAGG|ATGCAGGTCCAATAGTTAACTTTATCTAAT
TGAACGTTACCACACACTTACAACAGAACG|AACAGAACTGGCCTTGTCCTCATGCTCATC
TGTGGTTCGAACTAAACCTGCATGAAAAGC|TTTCCCGTTATCAGTGGATAGCACCACCGG
CCACACACTTACAACAGAACCATGTTGAAC|CGCTTGTTCGGAGGACCCGATCAGAGAAGA
TATTGTTGAACGTTACCACACACTTACAAC|ATGAAAAGCGTTGGAACGGGTAGGGAGAGT
ATCTATGCAGGTCCAATAGTTAACTTTATC|CAGACGACTGATAAGTGGCCAGTGAGCCAC
CGACATCCAGGCTGATACATAGGGCCCAAT|AACCAGGCTATTGTTGAACGTTACCACACA
TACAACAGAACAGCGACGATAACGATCCTT|TTGTCTCGCTGGGCGCACCACCGACTCACC
GTTTGAACGTTACCACACACTTACAACAGA|ATTGAATAGGTGTTTCAGGTTCTGGGGATC
GAGCCACCATGATTCTTCTACAGTGATTTG|GAATAAGTACTACAGGTTTCAACGGTGGTG
AACAGAACTCTATTGAACGTTACCACACAC|ACGGTGACGGGGTTCCTTCACAGAATTGAA
CACACACTTACAACAGAACTAGTCCACACC|TCAGGAACCGAGACGCTTGAACGTTACCAC
AACATTGCTGTGAATTCTAGCGCACCGACA|GGGAGTCTCAAGAGCGCAGAGGACCAACCA
CGAAGCTGATGGGCCAAATTTCCCGTTATC|GAGACGCTTGGTAAGTCGCGGCTTACCCAT
CCTGCCCGAGCACGAGTTAACCAGATATCT|GACTCGAACTCTCTTAAGAGAACTGAATGT
CAACAGAACCTCAGGAACCGAGACGCTTGA|TAACGTTGAACGTTACCACACACTTACAAC
TTGAACGTTACCACACACTTACAACAGAAC|CATAGGGCCCAATGTGCATGGCGTTGAACG
TACAACAGAACTACAACAGAACCTCAGGAA|GTAACATTTCGAGTAACGTTGAACGTTACC
ACCACACACTTACAACAGAACACTTATGTG|AACGGGTAGGGAGAGTTGAACGTTACCACA
ATGGTAAACACGACTGGTCGAACGTAACAT|AGAACCTTCCGTCGGGGAACTCCTTGTCGC
AACGGGAGAGCATGCTGACCGGGCGTCCAC|TTGAACGTTACCACACACTTTGAACGTTAC
TAGAACCTTCCGTCGGGGAACTCCTTGTCG|TCTACAGTGATTTGAACGTTACCACACACT
GGCGTTGAACGTTACCACACACTTACAACA|ACAGAACACTTATGTGCCCTTGTTTCACGG
TACATAGGGCCCAATGTGCATGGCGTTGAA|GAACGTTACCACACACTTACAACAGAACAC
CATTGCTGTGAATTCTAGCGCACCGACATC|GAGTCTCAAGAGCGCAGAGGACCAACCAGG
ACGAGTTAACCAGATATCTTTCGCAAACGA|TCTTAAGAGAACTGAATGTAACTCCAACGT
GTTACCACACACTTACAACAGAACGCTTGT|AACTGGCCTTGTCCTCATGCTCATCTATGC
AGGGTCGTCCGAAGCTGATGGGCCAAATTT|GCTCAGACTGAGACGCTTGGTAAGTCGCGG
GAAGCTGATGGGCCAAATTTCCCGTTATCA|AGACGCTTGGTAAGTCGCGGCTTACCCATC
TTGAACGTTACCACACACTTACAACAGAAC|TACAACAGAACGGTAACGCTTGTCTCGCTG
CTTACAACAGAACGCTTGTTCGGAGGACCC|TCCTCATGCTCATCTATGCAGGTCCAATAG
GCTTGGTAAGTCGCGGCTTACCCATCGTCC|TTGAACGTTACCACACACTTACAACAGAAC
TGAACGTTACCACACACTTACAACAGAACC|TCCTTCACAGAATTGAACGTTACCACACAC
GAACTCTATTGAACGTTACCACACACTTAC|TGACGGGGTTCCTTCACAGAATTGAACGTT
TACAACAGAACTAGTCCACACCAGCGTTTG|CGAGACGCTTGAACGTTACCACACACTTAC
CGAGCACGAGTTAACCAGATATCTTTCGCA|AACTCTCTTAAGAGAACTGAATGTAACTCC
CACCACCGGTTTGAACGTTACCACACACTT|GCGCCCAAATTGAATAGGTGTTTCAGGTTC
CTGATACATAGGGCCCAATGTGCATGGCGT|TGTTGAACGTTACCACACACTTACAACAGA
CGGGAGTCTCAAGAGCGCAGAGGACCAACC|CTTACAACAGAACTGTGGTTCGAACTAAAC
TGTACCTAGAACCTTCCGTCGGGGAACTCC|GATTCTTCTACAGTGATTTGAACGTTACCA
CCCTTGTTTCACGGTGACGGGGTTCCTTCA|CACTTACAACAGAACAGCGACGATAACGAT
ACACTTTGAACGTTACCACACACTTACAAC|TATGGTAAACACGACTGGTCGAACGTAACA
TGCATGAAAAGCGTTGGAACGGGTAGGGAG|TAGCACCACCGGTTTGAACGTTACCACACA
CCACACACTTACAACAGAACGCTTGTTCGG|GGCCTTGTCCTCATGCTCATCTATGCAGGT
ACCGGGAGTCTCAAGAGCGCAGAGGACCAA|CACTTACAACAGAACTGTGGTTCGAACTAA
CGACTGGTCGAACGTAACATTTCGAGTAAC|GTCGGGGAACTCCTTGTCGCGATCTACAAT
AGCCACCATGATTCTTCTACAGTGATTTGA|AATAAGTACTACAGGTTTCAACGGTGGTGA
TTCACGGTGACGGGGTTCCTTCACAGAATT|AACAGAACAGCGACGATAACGATCCTTAGA
ATCTACAATAAGCTTGAACGTTACCACACA|CAACAGAACGGGATCCGTCCTGCCCGAGCA
CTACAATAAGCTTGAACGTTACCACACACT|ACAGAACGGGATCCGTCCTGCCCGAGCACG
AACGCCACGCGCGCGGTAGTTTCCTCCCAT|ACGTTACCACACACTTACAACAGAACTCTA
CCAGCGTTTGAACGTTACCACACACTTACA|ACACACTTACAACAGAACGCTTGTTCGGAG
CGGTAACGCTTGTCTCGCTGGGCGCACCAC|CGGCATAAACGGGAGAGCATGCTGACCGGG
CGTTACCACACACTTACAACAGAACTGGCC|GAACGTTACCACACACTTACAACAGAACTC
CATTTCGAGTAACGTTGAACGTTACCACAC|CGCGATCTACAATAAGCTTGAACGTTACCA
TTGAACGTTACCACACACTTACAACAGAAC|AGCTTGAACGTTACCACACACTTACAACAG
AACACGACTGGTCGAACGTAACATTTCGAG|TTCCGTCGGGGAACTCCTTGTCGCGATCTA
GGTCGTCCGAAGCTGATGGGCCAAATTTCC|TCAGACTGAGACGCTTGGTAAGTCGCGGCT
ATAAACGGGAGAGCATGCTGACCGGGCGTC|ATGTTGAACGTTACCACACACTTTGAACGT
GCTCAGACTGAGACGCTTGGTAAGTCGCGG|TCAGAAGATCTAGCTTGAACGTTACCACAC
ACTTACAACAGAACGGTAACGCTTGTCTCG|GTTCTGGGGATCCCGGCATAAACGGGAGAG
CCTTGTCGCGATCTACAATAAGCTTGAACG|CACACACTTACAACAGAACGGGATCCGTCC
CCTTGTCCTCATGCTCATCTATGCAGGTCC|TCGGTCATAATAAGTCCAGACGACTGATAA
ATAGTTAACTTTATCTAATGTACCTAGAAC|TGGCCAGTGAGCCACCATGATTCTTCTACA
TGAACGTTACCACACACTTACAACAGAACT|GCTTGAACGTTACCACACACTTACAACAGA
ACGTTACCACACACTTACAACAGAACTCGG|TCCTGCCCGAGCACGAGTTAACCAGATATC
ACAGAACACTTATGTGCCCTTGTTTCACGG|GTTGAACGTTACCACACACTTACAACAGAA
CAACAGAACTAGTCCACACCAGCGTTTGAA|AGACGCTTGAACGTTACCACACACTTACAA
TACCACACACTTACAACAGAACGGTAACGC|TGTTTCAGGTTCTGGGGATCCCGGCATAAA
TAGACAGGGTCGTCCGAAGCTGATGGGCCA|CGCACGCTCAGACTGAGACGCTTGGTAAGT
GGCCTTGTCCTCATGCTCATCTATGCAGGT|ACTCGGTCATAATAAGTCCAGACGACTGAT
TTTGAACGTTACCACACACTTACAACAGAA|TTACAACAGAACGCTTGTTCGGAGGACCCG
GAAGATCTAGCTTGAACGTTACCACACACT|ACAACAGAACTACAACAGAACCTCAGGAAC
CTTGAACGTTACCACACACTTACAACAGAA|ACATAGGGCCCAATGTGCATGGCGTTGAAC
TGCTCATCTATGCAGGTCCAATAGTTAACT|AAGTCCAGACGACTGATAAGTGGCCAGTGA
ACTCTATTGAACGTTACCACACACTTACAA|ACGGGGTTCCTTCACAGAATTGAACGTTAC
CAGAACGCTTGTTCGGAGGACCCGATCAGA|GCTCATCTATGCAGGTCCAATAGTTAACTT
TTGAACGTTACCACACACTTACAACAGAAC|TGAATAGGTGTTTCAGGTTCTGGGGATCCC
ACTTTGAACGTTACCACACACTTACAACAG|TGGTAAACACGACTGGTCGAACGTAACATT
CACACACTTACAACAGAACGGTAACGCTTG|TTCAGGTTCTGGGGATCCCGGCATAAACGG
CTTACAACAGAACGCCACGCGCGCGGTAGT|ATGGCGTTGAACGTTACCACACACTTACAA
CGGGTAGGGAGAGTTGAACGTTACCACACA|GTTACCACACACTTACAACAGAACGGTAAC
CCACTTAACATTGCTGTGAATTCTAGCGCA|AGAACCGGGAGTCTCAAGAGCGCAGAGGAC
GTAACGCTTGTCTCGCTGGGCGCACCACCG|GCATAAACGGGAGAGCATGCTGACCGGGCG
CCCGGCATAAACGGGAGAGCATGCTGACCG|AGAACCATGTTGAACGTTACCACACACTTT
ATGAAAAGCGTTGGAACGGGTAGGGAGAGT|CACCACCGGTTTGAACGTTACCACACACTT
ACACACTTACAACAGAACGGGATCCGTCCT|TGGTTTATCTCAGATACGGAGGTGAAGGAC
AGTGAAGGCACGGTTCGTACACCACTTAAC|ACGTTACCACACACTTACAACAGAACCGGG
AAGTCGCGGCTTACCCATCGTCCTAGTGCG|TTACCACACACTTACAACAGAACTAGTCCA
AGAATTGAACGTTACCACACACTTACAACA|CTTAGACAGGGTCGTCCGAAGCTGATGGGC
CATCTATGCAGGTCCAATAGTTAACTTTAT|CCAGACGACTGATAAGTGGCCAGTGAGCCA
CACCGCACGCTCAGACTGAGACGCTTGGTA|ACCCTGGTTCAGAAGATCTAGCTTGAACGT
GGCCCAATGTGCATGGCGTTGAACGTTACC|ACCACACACTTACAACAGAACACTTATGTG
AGACAGGGTCGTCCGAAGCTGATGGGCCAA|GCACGCTCAGACTGAGACGCTTGGTAAGTC
GAACCGGGAGTCTCAAGAGCGCAGAGGACC|CACACTTACAACAGAACTGTGGTTCGAACT
ACGTTACCACACACTTACAACAGAACTGTG|GGGTCGTCCGAAGCTGATGGGCCAAATTTC
GAACGTTACCACACACTTACAACAGAACTA|AACAGAACCTCAGGAACCGAGACGCTTGAA
CCACCGACTCACCGCACGCTCAGACTGAGA|CGGGCGTCCACCCTGGTTCAGAAGATCTAG
TGGATAGCACCACCGGTTTGAACGTTACCA|TCCTAGTGCGCCCAAATTGAATAGGTGTTT
GGGCCAAATTTCCCGTTATCAGTGGATAGC|GTAAGTCGCGGCTTACCCATCGTCCTAGTG
GTCGCGATCTACAATAAGCTTGAACGTTAC|CACTTACAACAGAACGGGATCCGTCCTGCC
TATCAGTGGATAGCACCACCGGTTTGAACG|CCATCGTCCTAGTGCGCCCAAATTGAATAG
CACACACTTACAACAGAACGCTTGTTCGGA|GCCTTGTCCTCATGCTCATCTATGCAGGTC
GTAGTTTCCTCCCATTGGCAGTGAAGGCAC|TACAACAGAACTCTATTGAACGTTACCACA
TTATCAGTGGATAGCACCACCGGTTTGAAC|CCCATCGTCCTAGTGCGCCCAAATTGAATA
TCCTTAGACAGGGTCGTCCGAAGCTGATGG|TCACCGCACGCTCAGACTGAGACGCTTGGT
GGGTCTTGAACGTTACCACACACTTACAAC|TGATACATAGGGCCCAATGTGCATGGCGTT
CAGGGTCGTCCGAAGCTGATGGGCCAAATT|CGCTCAGACTGAGACGCTTGGTAAGTCGCG
CCTGGTTCAGAAGATCTAGCTTGAACGTTA|CACACACTTACAACAGAACTACAACAGAAC
CACACACTTACAACAGAACGGGATCCGTCC|CTGGTTTATCTCAGATACGGAGGTGAAGGA
AATAGGTGTTTCAGGTTCTGGGGATCCCGG|TTGAACGTTACCACACACTTACAACAGAAC
GAACGTTACCACACACTTACAACAGAACAC|GCGTTGGAACGGGTAGGGAGAGTTGAACGT
AACGTTACCACACACTTACAACAGAACTCG|GTCCTGCCCGAGCACGAGTTAACCAGATAT
ACAACAGAACTACAACAGAACCTCAGGAAC|TAACATTTCGAGTAACGTTGAACGTTACCA
AACATTTCGAGTAACGTTGAACGTTACCAC|GTCGCGATCTACAATAAGCTTGAACGTTAC
ACGGTAACGCTTGTCTCGCTGGGCGCACCA|CCGGCATAAACGGGAGAGCATGCTGACCGG
AGGTCCAATAGTTAACTTTATCTAATGTAC|TGATAAGTGGCCAGTGAGCCACCATGATTC
AACAGAACGGTAACGCTTGTCTCGCTGGGC|GGGATCCCGGCATAAACGGGAGAGCATGCT
CACACACTTTGAACGTTACCACACACTTAC|CTTTATGGTAAACACGACTGGTCGAACGTA
TGAACGTTACCACACACTTACAACAGAACT|ACAGGGTCGTCCGAAGCTGATGGGCCAAAT
TTACCACACACTTACAACAGAACTCGGTCA|TGCCCGAGCACGAGTTAACCAGATATCTTT
AGAACCATGTTGAACGTTACCACACACTTT|CCCGATCAGAGAAGAAGGAACTTTATGGTA
ATTTCCCGTTATCAGTGGATAGCACCACCG|GCGGCTTACCCATCGTCCTAGTGCGCCCAA
TAAACCTGCATGAAAAGCGTTGGAACGGGT|AGTGGATAGCACCACCGGTTTGAACGTTAC
GTGGTTCGAACTAAACCTGCATGAAAAGCG|TTCCCGTTATCAGTGGATAGCACCACCGGT
CGTTGGAACGGGTAGGGAGAGTTGAACGTT|GTTTGAACGTTACCACACACTTACAACAGA
TTACCACACACTTACAACAGAACTGGCCTT|ACGTTACCACACACTTACAACAGAACTCGG
TTACCACACACTTACAACAGAACTAGTCCA|AACCTCAGGAACCGAGACGCTTGAACGTTA
CCTTCCGTCGGGGAACTCCTTGTCGCGATC|AGTGATTTGAACGTTACCACACACTTACAA
GTTTCAGGTTCTGGGGATCCCGGCATAAAC|TTACCACACACTTACAACAGAACCATGTTG
GAACCATGTTGAACGTTACCACACACTTTG|CCGATCAGAGAAGAAGGAACTTTATGGTAA
CTGGTTCAGAAGATCTAGCTTGAACGTTAC|ACACACTTACAACAGAACTACAACAGAACC
GTCCAGACGACTGATAAGTGGCCAGTGAGC|CGATGCACATTCTAATAAGGCTCATCGAAT
CGGGAGAGCATGCTGACCGGGCGTCCACCC|GAACGTTACCACACACTTTGAACGTTACCA
CGTTACCACACACTTACAACAGAACTGTGG|GGTCGTCCGAAGCTGATGGGCCAAATTTCC
CTTACAACAGAACTACAACAGAACCTCAGG|ACGTAACATTTCGAGTAACGTTGAACGTTA
GTTCAGAAGATCTAGCTTGAACGTTACCAC|CACTTACAACAGAACTACAACAGAACCTCA
CGTTACCACACACTTACAACAGAACGGTAA|AGGTGTTTCAGGTTCTGGGGATCCCGGCAT
GTTACCACACACTTTGAACGTTACCACACA|AGGAACTTTATGGTAAACACGACTGGTCGA
AAGTCCAGACGACTGATAAGTGGCCAGTGA|AACGATGCACATTCTAATAAGGCTCATCGA
GAACGTTACCACACACTTACAACAGAACGC|TAGGGCCCAATGTGCATGGCGTTGAACGTT
ATCTAATGTACCTAGAACCTTCCGTCGGGG|CACCATGATTCTTCTACAGTGATTTGAACG
GAACTGGCCTTGTCCTCATGCTCATCTATG|ACAGAACTCGGTCATAATAAGTCCAGACGA
CTAAACCTGCATGAAAAGCGTTGGAACGGG|CAGTGGATAGCACCACCGGTTTGAACGTTA
GCGTTGGAACGGGTAGGGAGAGTTGAACGT|GGTTTGAACGTTACCACACACTTACAACAG
CCCGAGCACGAGTTAACCAGATATCTTTCG|CGAACTCTCTTAAGAGAACTGAATGTAACT
GACCCGATCAGAGAAGAAGGAACTTTATGG|AATAGTTAACTTTATCTAATGTACCTAGAA
CACCACCGACTCACCGCACGCTCAGACTGA|ACCGGGCGTCCACCCTGGTTCAGAAGATCT
CACTTACAACAGAACTACAACAGAACCTCA|GAACGTAACATTTCGAGTAACGTTGAACGT
CAGGGTCTTGAACGTTACCACACACTTACA|GCTGATACATAGGGCCCAATGTGCATGGCG
CCACACACTTACAACAGAACGCCACGCGCG|AATGTGCATGGCGTTGAACGTTACCACACA
GGTCCAATAGTTAACTTTATCTAATGTACC|GATAAGTGGCCAGTGAGCCACCATGATTCT
GGGGATCCCGGCATAAACGGGAGAGCATGC|TACAACAGAACCATGTTGAACGTTACCACA
AACCTTCCGTCGGGGAACTCCTTGTCGCGA|ACAGTGATTTGAACGTTACCACACACTTAC
CTGGGCGCACCACCGACTCACCGCACGCTC|CATGCTGACCGGGCGTCCACCCTGGTTCAG
GGGCCCAATGTGCATGGCGTTGAACGTTAC|TACCACACACTTACAACAGAACACTTATGT
ATCTAGCTTGAACGTTACCACACACTTACA|CAGAACTACAACAGAACCTCAGGAACCGAG
ACACACTTACAACAGAACTACAACAGAACC|GTCGAACGTAACATTTCGAGTAACGTTGAA
GTGATTTGAACGTTACCACACACTTACAAC|CGGTGGTGAGAAAACTCTGGTTTATCTCAG
CGCGCGCGGTAGTTTCCTCCCATTGGCAGT|CACACACTTACAACAGAACTCTATTGAACG
ACTTACAACAGAACGGGATCCGTCCTGCCC|TTATCTCAGATACGGAGGTGAAGGACTCGA
CTTACAACAGAACTAGTCCACACCAGCGTT|ACCGAGACGCTTGAACGTTACCACACACTT
ATGTTGAACGTTACCACACACTTTGAACGT|CAGAGAAGAAGGAACTTTATGGTAAACACG
CCAATGTGCATGGCGTTGAACGTTACCACA|ACACACTTACAACAGAACACTTATGTGCCC
CTTGTCCTCATGCTCATCTATGCAGGTCCA|CGGTCATAATAAGTCCAGACGACTGATAAG
CACTTACAACAGAACGGTAACGCTTGTCTC|GGTTCTGGGGATCCCGGCATAAACGGGAGA
TGTCGCGATCTACAATAAGCTTGAACGTTA|ACACTTACAACAGAACGGGATCCGTCCTGC
TGTTTCACGGTGACGGGGTTCCTTCACAGA|TACAACAGAACAGCGACGATAACGATCCTT
GCCCGAGCACGAGTTAACCAGATATCTTTC|TCGAACTCTCTTAAGAGAACTGAATGTAAC
AACGTTACCACACACTTACAACAGAACAGC|AACAGAACGGTAACGCTTGTCTCGCTGGGC
TTACCACACACTTACAACAGAACACTTATG|GGAACGGGTAGGGAGAGTTGAACGTTACCA
GGAGAGTTGAACGTTACCACACACTTACAA|CACACTTACAACAGAACGGTAACGCTTGTC
CCATGATTCTTCTACAGTGATTTGAACGTT|GTACTACAGGTTTCAACGGTGGTGAGAAAA
CACCGACTCACCGCACGCTCAGACTGAGAC|GGGCGTCCACCCTGGTTCAGAAGATCTAGC
CAGACGACTGATAAGTGGCCAGTGAGCCAC|TGCACATTCTAATAAGGCTCATCGAATAAG
GTCGTCCGAAGCTGATGGGCCAAATTTCCC|CAGACTGAGACGCTTGGTAAGTCGCGGCTT
TTGAATAGGTGTTTCAGGTTCTGGGGATCC|CGTTTGAACGTTACCACACACTTACAACAG
GTTGAACGTTACCACACACTTACAACAGAA|AAAGCGTTGGAACGGGTAGGGAGAGTTGAA
AGAACAGCGACGATAACGATCCTTAGACAG|CGCTGGGCGCACCACCGACTCACCGCACGC
CCCAATGTGCATGGCGTTGAACGTTACCAC|CACACACTTACAACAGAACACTTATGTGCC
AGACGCTTGGTAAGTCGCGGCTTACCCATC|TAGCTTGAACGTTACCACACACTTACAACA
TTTATGGTAAACACGACTGGTCGAACGTAA|CCTAGAACCTTCCGTCGGGGAACTCCTTGT
AGCTTGAACGTTACCACACACTTACAACAG|ACTACAACAGAACCTCAGGAACCGAGACGC
ACTTACAACAGAACTACAACAGAACCTCAG|AACGTAACATTTCGAGTAACGTTGAACGTT
TGCAGGTCCAATAGTTAACTTTATCTAATG|GACTGATAAGTGGCCAGTGAGCCACCATGA
TGAACGTTACCACACACTTACAACAGAACA|AGCGTTGGAACGGGTAGGGAGAGTTGAACG
CGTAACATTTCGAGTAACGTTGAACGTTAC|CTTGTCGCGATCTACAATAAGCTTGAACGT
CAGGTTCTGGGGATCCCGGCATAAACGGGA|CACACACTTACAACAGAACCATGTTGAACG
CTTACAACAGAACTCGGTCATAATAAGTCC|CGAGTTAACCAGATATCTTTCGCAAACGAT
GAACCGAGACGCTTGAACGTTACCACACAC|ACCACACACTTACAACAGAACTGGCCTTGT
AGAAGATCTAGCTTGAACGTTACCACACAC|TACAACAGAACTACAACAGAACCTCAGGAA
GTAGGGAGAGTTGAACGTTACCACACACTT|ACCACACACTTACAACAGAACGGTAACGCT
CAGAACCATGTTGAACGTTACCACACACTT|ACCCGATCAGAGAAGAAGGAACTTTATGGT
GAACTACAACAGAACCTCAGGAACCGAGAC|TTCGAGTAACGTTGAACGTTACCACACACT
ATACATAGGGCCCAATGTGCATGGCGTTGA|TGAACGTTACCACACACTTACAACAGAACA
CTTACAACAGAACAGCGACGATAACGATCC|GCTTGTCTCGCTGGGCGCACCACCGACTCA
CATGCTCATCTATGCAGGTCCAATAGTTAA|ATAAGTCCAGACGACTGATAAGTGGCCAGT
CACACTTACAACAGAACGGTAACGCTTGTC|CAGGTTCTGGGGATCCCGGCATAAACGGGA
TCAGAAGATCTAGCTTGAACGTTACCACAC|CTTACAACAGAACTACAACAGAACCTCAGG
CACACACTTACAACAGAACTGGCCTTGTCC|TACCACACACTTACAACAGAACTCGGTCAT
CTGATAAGTGGCCAGTGAGCCACCATGATT|TCTAATAAGGCTCATCGAATAAGTACTACA
ATTGAACGTTACCACACACTTACAACAGAA|GTTCCTTCACAGAATTGAACGTTACCACAC
GCTTGAACGTTACCACACACTTACAACAGA|CTACAACAGAACCTCAGGAACCGAGACGCT
CATGCTGACCGGGCGTCCACCCTGGTTCAG|CCACACACTTTGAACGTTACCACACACTTA
GAGTCTCAAGAGCGCAGAGGACCAACCAGG|ACAACAGAACTGTGGTTCGAACTAAACCTG
CACACTTACAACAGAACTCGGTCATAATAA|AGCACGAGTTAACCAGATATCTTTCGCAAA
CGTTGAACGTTACCACACACTTACAACAGA|TAAGCTTGAACGTTACCACACACTTACAAC
AGCACCACCGGTTTGAACGTTACCACACAC|GTGCGCCCAAATTGAATAGGTGTTTCAGGT
GGAGGACCCGATCAGAGAAGAAGGAACTTT|GTCCAATAGTTAACTTTATCTAATGTACCT
GATCTACAATAAGCTTGAACGTTACCACAC|ACAACAGAACGGGATCCGTCCTGCCCGAGC
TACAACAGAACGCCACGCGCGCGGTAGTTT|GGCGTTGAACGTTACCACACACTTACAACA
GGGGAACTCCTTGTCGCGATCTACAATAAG|AACGTTACCACACACTTACAACAGAACGGG
CTTACAACAGAACCGGGAGTCTCAAGAGCG|ACGTTACCACACACTTACAACAGAACTGTG
TCACGGTGACGGGGTTCCTTCACAGAATTG|ACAGAACAGCGACGATAACGATCCTTAGAC
ATGTGCCCTTGTTTCACGGTGACGGGGTTC|CCACACACTTACAACAGAACAGCGACGATA
CCGGGCGTCCACCCTGGTTCAGAAGATCTA|TTTGAACGTTACCACACACTTACAACAGAA
CTCATCTATGCAGGTCCAATAGTTAACTTT|GTCCAGACGACTGATAAGTGGCCAGTGAGC
TGTGCCCTTGTTTCACGGTGACGGGGTTCC|CACACACTTACAACAGAACAGCGACGATAA
GCAGAGGACCAACCAGGCTATTGTTGAACG|GGTTCGAACTAAACCTGCATGAAAAGCGTT
ATAAGTGGCCAGTGAGCCACCATGATTCTT|AATAAGGCTCATCGAATAAGTACTACAGGT
TGCTGACCGGGCGTCCACCCTGGTTCAGAA|ACACACTTTGAACGTTACCACACACTTACA
TTCGGAGGACCCGATCAGAGAAGAAGGAAC|CAGGTCCAATAGTTAACTTTATCTAATGTA
