AAAACGCTGCCGATGCAGA -> AAACGCTGCCGATGCAGAT
AAAACGTCCGTACTGGCCT -> AAACGTCCGTACTGGCCTG
AAAACTGGTCAATCAACAG -> AAACTGGTCAATCAACAGG
AAAAGCGCGGAGGTACTGC -> AAAGCGCGGAGGTACTGCT
AAAATTAGATAGTAGGCTG -> AAATTAGATAGTAGGCTGT
AAACAGAGGGGCGTGCCCG -> AACAGAGGGGCGTGCCCGA
AAACCAGGTCACACGGGCA -> AACCAGGTCACACGGGCAA
AAACCGGAGACGTCTTATT -> AACCGGAGACGTCTTATTA
AAACCGTCCCTTATTGTAA -> AACCGTCCCTTATTGTAAC
AAACGACCTTTGCGTTTGT -> AACGACCTTTGCGTTTGTT
AAACGCTGCCGATGCAGAT -> AACGCTGCCGATGCAGATC
AAACGTCCGTACTGGCCTG -> AACGTCCGTACTGGCCTGG
AAACTGGTCAATCAACAGG -> AACTGGTCAATCAACAGGA
AAACTTCTGGTGTAACCGC -> AACTTCTGGTGTAACCGCT
AAAGCAAAGGGTTAAAAGC -> AAGCAAAGGGTTAAAAGCG
AAAGCCCTTTCAAATCACT -> AAGCCCTTTCAAATCACTC
AAAGCCGTTCATACTCCTA -> AAGCCGTTCATACTCCTAA
AAAGCGCGGAGGTACTGCT -> AAGCGCGGAGGTACTGCTT
AAAGCGGCCCTCTACTGGT -> AAGCGGCCCTCTACTGGTA
AAAGCTGCCTCTTGACTAT -> AAGCTGCCTCTTGACTATC
AAAGCTTAACCTACAGTGC -> AAGCTTAACCTACAGTGCT
AAAGGATGCGCGTACTTGG -> AAGGATGCGCGTACTTGGC
AAAGGGCAGTAACAGTAAA -> AAGGGCAGTAACAGTAAAA
AAAGGGTTAAAAGCGCGGA -> AAGGGTTAAAAGCGCGGAG
AAAGGTATAAGACATCAAG -> AAGGTATAAGACATCAAGG
AAAGGTGTATTCATATAGG -> AAGGTGTATTCATATAGGC
AAAGTACCCCCTAAGAAAG -> AAGTACCCCCTAAGAAAGC
AAAGTGCGGATTGTCTTTA -> AAGTGCGGATTGTCTTTAC
AAAGTTGCAGTAGTTATTC -> AAGTTGCAGTAGTTATTCC
AAAGTTGGCAATCACACTG -> AAGTTGGCAATCACACTGC
AAATAAAGTACCCCCTAAG -> AATAAAGTACCCCCTAAGA
AAATAACCCGGAGTAGCAG -> AATAACCCGGAGTAGCAGT
AAATAATGTTGGACAACAG -> AATAATGTTGGACAACAGC
AAATACTATAAGCTAGTCA -> AATACTATAAGCTAGTCAG
AAATAGTACTTGTAAGCCC -> AATAGTACTTGTAAGCCCT
AAATATACTTTCTGGTTGT -> AATATACTTTCTGGTTGTC
AAATCACTCCCCGTGTCAT -> AATCACTCCCCGTGTCATG
AAATGCCTAATATCGATCC -> AATGCCTAATATCGATCCG
AAATGGCCTGGAAGTCCAG -> AATGGCCTGGAAGTCCAGC
AAATGGTTAGCTGCACCGG -> AATGGTTAGCTGCACCGGA
AAATTAATAACCCTCGCAG -> AATTAATAACCCTCGCAGA
AAATTAGATAGTAGGCTGT -> AATTAGATAGTAGGCTGTT
AAATTATAATTACGGATCC -> AATTATAATTACGGATCCG
AAATTCCAAGTATTCAGAG -> AATTCCAAGTATTCAGAGA
AAATTGAGCAAGTCCACAT -> AATTGAGCAAGTCCACATT
AACACCGGTTCATTCATAA -> ACACCGGTTCATTCATAAA
AACACTTCTATAGACTATA -> ACACTTCTATAGACTATAG
AACAGAGGGGCGTGCCCGA -> ACAGAGGGGCGTGCCCGAG
AACAGCGGTTCCAAGAAAG -> ACAGCGGTTCCAAGAAAGG
AACAGGACCGGGTTCGTGG -> ACAGGACCGGGTTCGTGGC
AACAGTAAAACTGGTCAAT -> ACAGTAAAACTGGTCAATC
AACAGTACGCGATAGGTAT -> ACAGTACGCGATAGGTATC
AACATAGAATATGTAAATT -> ACATAGAATATGTAAATTG
AACATAGCATGTGCGTTTT -> ACATAGCATGTGCGTTTTG
AACATAGGCATTTGTAGAC -> ACATAGGCATTTGTAGACG
AACATAGTTACCCCCTTAT -> ACATAGTTACCCCCTTATG
AACCACAAATAAAGTACCC -> ACCACAAATAAAGTACCCC
AACCAGGTCACACGGGCAA -> ACCAGGTCACACGGGCAAA
AACCCGAGCCCTCATACTA -> ACCCGAGCCCTCATACTAC
AACCCGGAGTAGCAGTACC -> ACCCGGAGTAGCAGTACCA
AACCCTATTTAGGCTGCAA -> ACCCTATTTAGGCTGCAAT
AACCCTCGCAGAGAACTCT -> ACCCTCGCAGAGAACTCTT
AACCGCTGGCCAAATAACC -> ACCGCTGGCCAAATAACCC
AACCGGAGACGTCTTATTA -> ACCGGAGACGTCTTATTAA
AACCGTCCCTTATTGTAAC -> ACCGTCCCTTATTGTAACA
AACCTACAGTGCTGAGGCT -> ACCTACAGTGCTGAGGCTT
AACCTTAAAATTAGATAGT -> ACCTTAAAATTAGATAGTA
AACGACCTTTGCGTTTGTT -> ACGACCTTTGCGTTTGTTG
AACGCTGCCGATGCAGATC -> ACGCTGCCGATGCAGATCA
AACGGGTGTGTCCCCAAAA -> ACGGGTGTGTCCCCAAAAC
AACGTCCGTACTGGCCTGG -> ACGTCCGTACTGGCCTGGT
AACTCTTCTTTCGGATTCA -> ACTCTTCTTTCGGATTCAC
AACTGGTCAATCAACAGGA -> ACTGGTCAATCAACAGGAC
AACTTATTAGCAACCACAA -> ACTTATTAGCAACCACAAA
AACTTCTGGTGTAACCGCT -> ACTTCTGGTGTAACCGCTG
AAGAAAGCTTAACCTACAG -> AGAAAGCTTAACCTACAGT
AAGAAAGGTATAAGACATC -> AGAAAGGTATAAGACATCA
AAGAAATTATAATTACGGA -> AGAAATTATAATTACGGAT
AAGACAATCAAGCAAATTA -> AGACAATCAAGCAAATTAA
AAGACATCAAGGAATAAGA -> AGACATCAAGGAATAAGAT
AAGACGACATTGAATACCG -> AGACGACATTGAATACCGC
AAGACGAGGCTCACGACAT -> AGACGAGGCTCACGACATT
AAGACGGTCTTTGGTCCAC -> AGACGGTCTTTGGTCCACT
AAGATCTTGAAACAGAGGG -> AGATCTTGAAACAGAGGGG
AAGATTCCTGGAATCATAC -> AGATTCCTGGAATCATACC
AAGCAAAGGGTTAAAAGCG -> AGCAAAGGGTTAAAAGCGC
AAGCAAATTAATAACCCTC -> AGCAAATTAATAACCCTCG
AAGCAAGCAGCTGGGTTAG -> AGCAAGCAGCTGGGTTAGT
AAGCAGCTGGGTTAGTGTG -> AGCAGCTGGGTTAGTGTGG
AAGCCCTCAATGCATTGGC -> AGCCCTCAATGCATTGGCG
AAGCCCTTTCAAATCACTC -> AGCCCTTTCAAATCACTCC
AAGCCGCACCTGAGAAAGT -> AGCCGCACCTGAGAAAGTT
AAGCCGTTCATACTCCTAA -> AGCCGTTCATACTCCTAAT
AAGCGCGGAGGTACTGCTT -> AGCGCGGAGGTACTGCTTA
AAGCGGCCCTCTACTGGTA -> AGCGGCCCTCTACTGGTAA
AAGCTAGTCAGACCTGTTC -> AGCTAGTCAGACCTGTTCA
AAGCTGCCTCTTGACTATC -> AGCTGCCTCTTGACTATCC
AAGCTTAACCTACAGTGCT -> AGCTTAACCTACAGTGCTG
AAGGAATAAGATTCCTGGA -> AGGAATAAGATTCCTGGAA
AAGGATAAATGGTTAGCTG -> AGGATAAATGGTTAGCTGC
AAGGATGCCGGCGGTCAGA -> AGGATGCCGGCGGTCAGAC
AAGGATGCGCGTACTTGGC -> AGGATGCGCGTACTTGGCC
AAGGATGGTTAACCTTAAA -> AGGATGGTTAACCTTAAAA
AAGGGCAGTAACAGTAAAA -> AGGGCAGTAACAGTAAAAC
AAGGGGCGCTATCGGCAGA -> AGGGGCGCTATCGGCAGAT
AAGGGTATGGAAAGGGCAG -> AGGGTATGGAAAGGGCAGT
AAGGGTTAAAAGCGCGGAG -> AGGGTTAAAAGCGCGGAGG
AAGGTATAAGACATCAAGG -> AGGTATAAGACATCAAGGA
AAGGTCATCCACTCTTATC -> AGGTCATCCACTCTTATCG
AAGGTGCTATCAGAGAGCA -> AGGTGCTATCAGAGAGCAT
AAGGTGTATTCATATAGGC -> AGGTGTATTCATATAGGCG
AAGTACCCCCTAAGAAAGC -> AGTACCCCCTAAGAAAGCT
AAGTATTCAGAGACATTCT -> AGTATTCAGAGACATTCTC
AAGTCCACATTGCCCGCTC -> AGTCCACATTGCCCGCTCG
AAGTCCACATTGCCGCAGT -> AGTCCACATTGCCGCAGTC
AAGTCCACATTGCCGTGCA -> AGTCCACATTGCCGTGCAG
AAGTCCACATTGCCTGACA -> AGTCCACATTGCCTGACAT
AAGTCCAGCTTCAAGCAAG -> AGTCCAGCTTCAAGCAAGC
AAGTGAGAGTCCCCCGGTA -> AGTGAGAGTCCCCCGGTAC
AAGTGATGCGGTTGGACGC -> AGTGATGCGGTTGGACGCA
AAGTGCGGATTGTCTTTAC -> AGTGCGGATTGTCTTTACT
AAGTTCACTGACAAAGTGC -> AGTTCACTGACAAAGTGCG
AAGTTGCAGTAGTTATTCC -> AGTTGCAGTAGTTATTCCT
AAGTTGCTGGCTCCCGGAA -> AGTTGCTGGCTCCCGGAAG
AAGTTGGCAATCACACTGC -> AGTTGGCAATCACACTGCC
AATAAAGTACCCCCTAAGA -> ATAAAGTACCCCCTAAGAA
AATAACCCGGAGTAGCAGT -> ATAACCCGGAGTAGCAGTA
AATAACCCTCGCAGAGAAC -> ATAACCCTCGCAGAGAACT
AATAAGATTCCTGGAATCA -> ATAAGATTCCTGGAATCAT
AATAATGTTGGACAACAGC -> ATAATGTTGGACAACAGCG
AATACCGCTTCTCCGTAGA -> ATACCGCTTCTCCGTAGAC
AATACCTAATTCTTCTGCG -> ATACCTAATTCTTCTGCGC
AATACTATAAGCTAGTCAG -> ATACTATAAGCTAGTCAGA
AATAGTACTTGTAAGCCCT -> ATAGTACTTGTAAGCCCTC
AATAGTAGACGCTTTAACA -> ATAGTAGACGCTTTAACAT
AATATACTTTCTGGTTGTC -> ATATACTTTCTGGTTGTCC
AATATCGATCCGGGAAGCC -> ATATCGATCCGGGAAGCCG
AATATGTAAATTGAGCAAG -> ATATGTAAATTGAGCAAGT
AATCAACAGGACCGGGTTC -> ATCAACAGGACCGGGTTCG
AATCAAGATCTTGAAACAG -> ATCAAGATCTTGAAACAGA
AATCAAGCAAATTAATAAC -> ATCAAGCAAATTAATAACC
AATCAAGTTCACTGACAAA -> ATCAAGTTCACTGACAAAG
AATCACACTGCCATAAGTG -> ATCACACTGCCATAAGTGA
AATCACTCCCCGTGTCATG -> ATCACTCCCCGTGTCATGT
AATGAAGGTCATCCACTCT -> ATGAAGGTCATCCACTCTT
AATGCAAATGGCCTGGAAG -> ATGCAAATGGCCTGGAAGT
AATGCATTGGCGGCGGATT -> ATGCATTGGCGGCGGATTA
AATGCCTAATATCGATCCG -> ATGCCTAATATCGATCCGG
AATGCGAGTGTATAGTTGT -> ATGCGAGTGTATAGTTGTC
AATGGAGCTTGTTGGAAAG -> ATGGAGCTTGTTGGAAAGG
AATGGCCTGGAAGTCCAGC -> ATGGCCTGGAAGTCCAGCT
AATGGTATGGTCTAGAGTA -> ATGGTATGGTCTAGAGTAT
AATGGTTAGCTGCACCGGA -> ATGGTTAGCTGCACCGGAC
AATGTACGCAGAAGACGAC -> ATGTACGCAGAAGACGACA
AATGTTGGACAACAGCGGT -> ATGTTGGACAACAGCGGTT
AATTAATAACCCTCGCAGA -> ATTAATAACCCTCGCAGAG
AATTACGGATCCGCTTGTT -> ATTACGGATCCGCTTGTTG
AATTACTGGCATCAAGACG -> ATTACTGGCATCAAGACGG
AATTAGATAGTAGGCTGTT -> ATTAGATAGTAGGCTGTTT
AATTATAATTACGGATCCG -> ATTATAATTACGGATCCGC
AATTCCAAGTATTCAGAGA -> ATTCCAAGTATTCAGAGAC
AATTCCTATAACGGGTGTG -> ATTCCTATAACGGGTGTGT
AATTCGCTGTCTACATAGT -> ATTCGCTGTCTACATAGTC
AATTCTTCTGCGCTTAGGG -> ATTCTTCTGCGCTTAGGGT
AATTGAGCAAGTCCACATT -> ATTGAGCAAGTCCACATTG
AATTGCATCGGCAGTCACT -> ATTGCATCGGCAGTCACTA
AATTGGACTTTAAATACTA -> ATTGGACTTTAAATACTAT
AATTTGGCATGTGTTTCCA -> ATTTGGCATGTGTTTCCAC
AATTTTGAATTCGCTGTCT -> ATTTTGAATTCGCTGTCTA
ACAAAGTGCGGATTGTCTT -> CAAAGTGCGGATTGTCTTT
ACAAATAAAGTACCCCCTA -> CAAATAAAGTACCCCCTAA
ACAACAGCGGTTCCAAGAA -> CAACAGCGGTTCCAAGAAA
ACAATCAAGCAAATTAATA -> CAATCAAGCAAATTAATAA
ACACCGGTTCATTCATAAA -> CACCGGTTCATTCATAAAC
ACACGAAGACAATCAAGCA -> CACGAAGACAATCAAGCAA
ACACGGGCAAAGTTGGCAA -> CACGGGCAAAGTTGGCAAT
ACACTGCCATAAGTGATGC -> CACTGCCATAAGTGATGCG
ACACTTCCCGCCGTTAAAC -> CACTTCCCGCCGTTAAACC
ACACTTCTATAGACTATAG -> CACTTCTATAGACTATAGT
ACAGAGGGGCGTGCCCGAG -> CAGAGGGGCGTGCCCGAGG
ACAGCCCACTCCAGAAGGG -> CAGCCCACTCCAGAAGGGG
ACAGCGGTTCCAAGAAAGG -> CAGCGGTTCCAAGAAAGGT
ACAGGACCGGGTTCGTGGC -> CAGGACCGGGTTCGTGGCA
ACAGGCGGAACCCGAGCCC -> CAGGCGGAACCCGAGCCCT
ACAGTAAAACTGGTCAATC -> CAGTAAAACTGGTCAATCA
ACAGTACGCGATAGGTATC -> CAGTACGCGATAGGTATCG
ACAGTGCTGAGGCTTGTCT -> CAGTGCTGAGGCTTGTCTA
ACATACCGTCCAGATTTTC -> CATACCGTCCAGATTTTCA
ACATAGAATATGTAAATTG -> CATAGAATATGTAAATTGA
ACATAGCATGTGCGTTTTG -> CATAGCATGTGCGTTTTGA
ACATAGGCATTTGTAGACG -> CATAGGCATTTGTAGACGC
ACATAGTCCCTATAATTTG -> CATAGTCCCTATAATTTGG
ACATAGTTACCCCCTTATG -> CATAGTTACCCCCTTATGA
ACATCAAGGAATAAGATTC -> CATCAAGGAATAAGATTCC
ACATTCGTCCAGTGCCCTT -> CATTCGTCCAGTGCCCTTC
ACATTCTCAGGCCAGAGCC -> CATTCTCAGGCCAGAGCCT
ACATTGAATACCGCTTCTC -> CATTGAATACCGCTTCTCC
ACATTGAGCAAGTCCACAT -> CATTGAGCAAGTCCACATT
ACATTGCCCGCTCGTGAAA -> CATTGCCCGCTCGTGAAAG
ACATTGCCGCAGTCGAAAG -> CATTGCCGCAGTCGAAAGC
ACATTGCCGTGCAGGGCAG -> CATTGCCGTGCAGGGCAGT
ACATTGCCTGACATTGAGC -> CATTGCCTGACATTGAGCA
ACATTGGGTAAAGCTGCCT -> CATTGGGTAAAGCTGCCTC
ACCACAAATAAAGTACCCC -> CCACAAATAAAGTACCCCC
ACCAGGTCACACGGGCAAA -> CCAGGTCACACGGGCAAAG
ACCAGTAGACACTTCCCGC -> CCAGTAGACACTTCCCGCC
ACCCAATTGCATCGGCAGT -> CCCAATTGCATCGGCAGTC
ACCCCCTAAGAAAGCTTAA -> CCCCCTAAGAAAGCTTAAC
ACCCCCTTATGAGCAAGTC -> CCCCCTTATGAGCAAGTCC
ACCCGAATACCTAATTCTT -> CCCGAATACCTAATTCTTC
ACCCGAGCCCTCATACTAC -> CCCGAGCCCTCATACTACG
ACCCGGAGTAGCAGTACCA -> CCCGGAGTAGCAGTACCAG
ACCCTATTTAGGCTGCAAT -> CCCTATTTAGGCTGCAATG
ACCCTCGCAGAGAACTCTT -> CCCTCGCAGAGAACTCTTC
ACCGCTGGCCAAATAACCC -> CCGCTGGCCAAATAACCCG
ACCGCTTCTCCGTAGACGC -> CCGCTTCTCCGTAGACGCT
ACCGGACACGAAGACAATC -> CCGGACACGAAGACAATCA
ACCGGAGACGTCTTATTAA -> CCGGAGACGTCTTATTAAT
ACCGGGTTCGTGGCAGTAG -> CCGGGTTCGTGGCAGTAGG
ACCGGTTCATTCATAAACT -> CCGGTTCATTCATAAACTT
ACCGTCCAGATTTTCATGT -> CCGTCCAGATTTTCATGTA
ACCGTCCCTTATTGTAACA -> CCGTCCCTTATTGTAACAC
ACCTAATTCTTCTGCGCTT -> CCTAATTCTTCTGCGCTTA
ACCTACAGTGCTGAGGCTT -> CCTACAGTGCTGAGGCTTG
ACCTACTTGAATAGTAGAC -> CCTACTTGAATAGTAGACG
ACCTGAGAAAGTTGCAGTA -> CCTGAGAAAGTTGCAGTAG
ACCTGTTCAGCAAGTTGCT -> CCTGTTCAGCAAGTTGCTG
ACCTTAAAATTAGATAGTA -> CCTTAAAATTAGATAGTAG
ACCTTTGCGTTTGTTGCAT -> CCTTTGCGTTTGTTGCATA
ACGAAGACAATCAAGCAAA -> CGAAGACAATCAAGCAAAT
ACGACATTGAATACCGCTT -> CGACATTGAATACCGCTTC
ACGACATTGGGTAAAGCTG -> CGACATTGGGTAAAGCTGC
ACGACCTTTGCGTTTGTTG -> CGACCTTTGCGTTTGTTGC
ACGAGGCTCACGACATTGG -> CGAGGCTCACGACATTGGG
ACGATGGTCGGCGGCTGAG -> CGATGGTCGGCGGCTGAGC
ACGCACATACCGTCCAGAT -> CGCACATACCGTCCAGATT
ACGCAGAAGACGACATTGA -> CGCAGAAGACGACATTGAA
ACGCGATAGGTATCGGGTA -> CGCGATAGGTATCGGGTAA
ACGCGCCCATCTCTCGACA -> CGCGCCCATCTCTCGACAG
ACGCTGCCGATGCAGATCA -> CGCTGCCGATGCAGATCAT
ACGCTTTAACATAGAATAT -> CGCTTTAACATAGAATATG
ACGCTTTAACATAGCATGT -> CGCTTTAACATAGCATGTG
ACGCTTTAACATAGGCATT -> CGCTTTAACATAGGCATTT
ACGCTTTAACATAGTTACC -> CGCTTTAACATAGTTACCC
ACGGATCCGCTTGTTGGGG -> CGGATCCGCTTGTTGGGGG
ACGGCCAAGGATGCCGGCG -> CGGCCAAGGATGCCGGCGG
ACGGGCAAAGTTGGCAATC -> CGGGCAAAGTTGGCAATCA
ACGGGTGTGTCCCCAAAAC -> CGGGTGTGTCCCCAAAACG
ACGGTCTTTGGTCCACTAG -> CGGTCTTTGGTCCACTAGT
ACGGTGGTGCATATCCAAA -> CGGTGGTGCATATCCAAAT
ACGTCCGTACTGGCCTGGT -> CGTCCGTACTGGCCTGGTA
ACGTCTTATTAATGCGAGT -> CGTCTTATTAATGCGAGTG
ACTAACTTATTAGCAACCA -> CTAACTTATTAGCAACCAC
ACTACGATGGTCGGCGGCT -> CTACGATGGTCGGCGGCTG
ACTACGGTGGTGCATATCC -> CTACGGTGGTGCATATCCA
ACTAGTTAGCTATCCCGTG -> CTAGTTAGCTATCCCGTGC
ACTATAAGCTAGTCAGACC -> CTATAAGCTAGTCAGACCT
ACTATAGTTGTGGTTGAAA -> CTATAGTTGTGGTTGAAAT
ACTATCCGCATCGTAATGA -> CTATCCGCATCGTAATGAA
ACTCCAGAAGGGGCGCTAT -> CTCCAGAAGGGGCGCTATC
ACTCCCCGTGTCATGTGTG -> CTCCCCGTGTCATGTGTGG
ACTCCTAATTGGACTTTAA -> CTCCTAATTGGACTTTAAA
ACTCTTATCGAGTTGACGG -> CTCTTATCGAGTTGACGGC
ACTCTTCTTTCGGATTCAC -> CTCTTCTTTCGGATTCACG
ACTGACAAAGTGCGGATTG -> CTGACAAAGTGCGGATTGT
ACTGCCATAAGTGATGCGG -> CTGCCATAAGTGATGCGGT
ACTGCTTAAAGCCGTTCAT -> CTGCTTAAAGCCGTTCATA
ACTGGCATCAAGACGGTCT -> CTGGCATCAAGACGGTCTT
ACTGGCCTGGTAGACGCTT -> CTGGCCTGGTAGACGCTTT
ACTGGTAATGTACGCAGAA -> CTGGTAATGTACGCAGAAG
ACTGGTCAATCAACAGGAC -> CTGGTCAATCAACAGGACC
ACTTATTAGCAACCACAAA -> CTTATTAGCAACCACAAAT
ACTTATTCAGGCTGAGGCC -> CTTATTCAGGCTGAGGCCG
ACTTCCCGCCGTTAAACCA -> CTTCCCGCCGTTAAACCAG
ACTTCTATAGACTATAGTT -> CTTCTATAGACTATAGTTG
ACTTCTGGTGTAACCGCTG -> CTTCTGGTGTAACCGCTGG
ACTTGAATAGTAGACGCTT -> CTTGAATAGTAGACGCTTT
ACTTGGCCGATTATGTAAT -> CTTGGCCGATTATGTAATC
ACTTGGGTGTCGAATCAAG -> CTTGGGTGTCGAATCAAGA
ACTTGTAAGCCCTCAATGC -> CTTGTAAGCCCTCAATGCA
ACTTTAAATACTATAAGCT -> CTTTAAATACTATAAGCTA
ACTTTCTGGTTGTCCGAAT -> CTTTCTGGTTGTCCGAATT
AGAAAGCTTAACCTACAGT -> GAAAGCTTAACCTACAGTG
AGAAAGGTATAAGACATCA -> GAAAGGTATAAGACATCAA
AGAAAGTTGCAGTAGTTAT -> GAAAGTTGCAGTAGTTATT
AGAAATTATAATTACGGAT -> GAAATTATAATTACGGATC
AGAACTCTTCTTTCGGATT -> GAACTCTTCTTTCGGATTC
AGAAGACGACATTGAATAC -> GAAGACGACATTGAATACC
AGAAGGGGCGCTATCGGCA -> GAAGGGGCGCTATCGGCAG
AGAATATGTAAATTGAGCA -> GAATATGTAAATTGAGCAA
AGACAATCAAGCAAATTAA -> GACAATCAAGCAAATTAAT
AGACACTTCCCGCCGTTAA -> GACACTTCCCGCCGTTAAA
AGACATCAAGGAATAAGAT -> GACATCAAGGAATAAGATT
AGACATTCTCAGGCCAGAG -> GACATTCTCAGGCCAGAGC
AGACCTACTTGAATAGTAG -> GACCTACTTGAATAGTAGA
AGACCTGTTCAGCAAGTTG -> GACCTGTTCAGCAAGTTGC
AGACGACATTGAATACCGC -> GACGACATTGAATACCGCT
AGACGAGGCTCACGACATT -> GACGAGGCTCACGACATTG
AGACGCTTTAACATAGAAT -> GACGCTTTAACATAGAATA
AGACGCTTTAACATAGCAT -> GACGCTTTAACATAGCATG
AGACGCTTTAACATAGGCA -> GACGCTTTAACATAGGCAT
AGACGCTTTAACATAGTTA -> GACGCTTTAACATAGTTAC
AGACGGTCTTTGGTCCACT -> GACGGTCTTTGGTCCACTA
AGACGTCTTATTAATGCGA -> GACGTCTTATTAATGCGAG
AGACTATAGTTGTGGTTGA -> GACTATAGTTGTGGTTGAA
AGAGAACTCTTCTTTCGGA -> GAGAACTCTTCTTTCGGAT
AGAGACATTCTCAGGCCAG -> GAGACATTCTCAGGCCAGA
AGAGAGCATGTAAACCGTC -> GAGAGCATGTAAACCGTCC
AGAGCATGTAAACCGTCCC -> GAGCATGTAAACCGTCCCT
AGAGCCTGGGGTCCGCCGT -> GAGCCTGGGGTCCGCCGTA
AGAGCTACCCAATTGCATC -> GAGCTACCCAATTGCATCG
AGAGGGGCGTGCCCGAGGC -> GAGGGGCGTGCCCGAGGCG
AGAGTATCGCTGAAATAGT -> GAGTATCGCTGAAATAGTA
AGAGTCCCCCGGTACTTAT -> GAGTCCCCCGGTACTTATT
AGATAGTAGGCTGTTTATC -> GATAGTAGGCTGTTTATCT
AGATCATATTCCGGGATGT -> GATCATATTCCGGGATGTC
AGATCGATGCGACAGGCGG -> GATCGATGCGACAGGCGGA
AGATCGTGATCGCAAGGGT -> GATCGTGATCGCAAGGGTA
AGATCTTGAAACAGAGGGG -> GATCTTGAAACAGAGGGGC
AGATTCCTGGAATCATACC -> GATTCCTGGAATCATACCC
AGATTTTCATGTAAGGTGC -> GATTTTCATGTAAGGTGCT
AGCAAAGGGTTAAAAGCGC -> GCAAAGGGTTAAAAGCGCG
AGCAAATTAATAACCCTCG -> GCAAATTAATAACCCTCGC
AGCAACCACAAATAAAGTA -> GCAACCACAAATAAAGTAC
AGCAAGCAGCTGGGTTAGT -> GCAAGCAGCTGGGTTAGTG
AGCAAGTCCACATTGCCCG -> GCAAGTCCACATTGCCCGC
AGCAAGTCCACATTGCCGC -> GCAAGTCCACATTGCCGCA
AGCAAGTCCACATTGCCGT -> GCAAGTCCACATTGCCGTG
AGCAAGTCCACATTGCCTG -> GCAAGTCCACATTGCCTGA
AGCAAGTTGCTGGCTCCCG -> GCAAGTTGCTGGCTCCCGG
AGCAGCTGGGTTAGTGTGG -> GCAGCTGGGTTAGTGTGGA
AGCAGTACCAGTAGACACT -> GCAGTACCAGTAGACACTT
AGCATGTAAACCGTCCCTT -> GCATGTAAACCGTCCCTTA
AGCATGTGCGTTTTGAGCA -> GCATGTGCGTTTTGAGCAA
AGCCCACTCCAGAAGGGGC -> GCCCACTCCAGAAGGGGCG
AGCCCTCAATGCATTGGCG -> GCCCTCAATGCATTGGCGG
AGCCCTCATACTACGATGG -> GCCCTCATACTACGATGGT
AGCCCTTTCAAATCACTCC -> GCCCTTTCAAATCACTCCC
AGCCGCACCTGAGAAAGTT -> GCCGCACCTGAGAAAGTTG
AGCCGCCCAGCTAAAGCGG -> GCCGCCCAGCTAAAGCGGC
AGCCGTTCATACTCCTAAT -> GCCGTTCATACTCCTAATT
AGCCTGGGGTCCGCCGTAT -> GCCTGGGGTCCGCCGTATC
AGCGCGGAGGTACTGCTTA -> GCGCGGAGGTACTGCTTAA
AGCGGCCCTCTACTGGTAA -> GCGGCCCTCTACTGGTAAT
AGCGGTTCCAAGAAAGGTA -> GCGGTTCCAAGAAAGGTAT
AGCTAAAGCGGCCCTCTAC -> GCTAAAGCGGCCCTCTACT
AGCTACCCAATTGCATCGG -> GCTACCCAATTGCATCGGC
AGCTAGTCAGACCTGTTCA -> GCTAGTCAGACCTGTTCAG
AGCTATCCCGTGCATGGCG -> GCTATCCCGTGCATGGCGG
AGCTGCACCGGACACGAAG -> GCTGCACCGGACACGAAGA
AGCTGCCTCTTGACTATCC -> GCTGCCTCTTGACTATCCG
AGCTGGGTTAGTGTGGATA -> GCTGGGTTAGTGTGGATAA
AGCTTAACCTACAGTGCTG -> GCTTAACCTACAGTGCTGA
AGCTTCAAGCAAGCAGCTG -> GCTTCAAGCAAGCAGCTGG
AGCTTGTTGGAAAGGATGC -> GCTTGTTGGAAAGGATGCG
AGGAAGTGAGAGTCCCCCG -> GGAAGTGAGAGTCCCCCGG
AGGAATAAGATTCCTGGAA -> GGAATAAGATTCCTGGAAT
AGGAATTCCTATAACGGGT -> GGAATTCCTATAACGGGTG
AGGACCGGGTTCGTGGCAG -> GGACCGGGTTCGTGGCAGT
AGGATAAATGGTTAGCTGC -> GGATAAATGGTTAGCTGCA
AGGATGCCGGCGGTCAGAC -> GGATGCCGGCGGTCAGACC
AGGATGCGCGTACTTGGCC -> GGATGCGCGTACTTGGCCG
AGGATGGTTAACCTTAAAA -> GGATGGTTAACCTTAAAAT
AGGCATTTGTAGACGCTTT -> GGCATTTGTAGACGCTTTA
AGGCCAGAGCCTGGGGTCC -> GGCCAGAGCCTGGGGTCCG
AGGCCGTAAAGGTGTATTC -> GGCCGTAAAGGTGTATTCA
AGGCGAAAACGTCCGTACT -> GGCGAAAACGTCCGTACTG
AGGCGGAACCCGAGCCCTC -> GGCGGAACCCGAGCCCTCA
AGGCGTGGCATGAACACCG -> GGCGTGGCATGAACACCGG
AGGCTCACGACATTGGGTA -> GGCTCACGACATTGGGTAA
AGGCTGAGGCCGTAAAGGT -> GGCTGAGGCCGTAAAGGTG
AGGCTGCAATGGAGCTTGT -> GGCTGCAATGGAGCTTGTT
AGGCTGTTTATCTCGCAAA -> GGCTGTTTATCTCGCAAAC
AGGCTTGTCTAGTCTGCAA -> GGCTTGTCTAGTCTGCAAA
AGGGCAGTAACAGTAAAAC -> GGGCAGTAACAGTAAAACT
AGGGCAGTTACTAACTTAT -> GGGCAGTTACTAACTTATT
AGGGGCGCTATCGGCAGAT -> GGGGCGCTATCGGCAGATC
AGGGGCGTGCCCGAGGCGT -> GGGGCGTGCCCGAGGCGTG
AGGGTATCAACAGTACGCG -> GGGTATCAACAGTACGCGA
AGGGTATGGAAAGGGCAGT -> GGGTATGGAAAGGGCAGTA
AGGGTTAAAAGCGCGGAGG -> GGGTTAAAAGCGCGGAGGT
AGGTACTGCTTAAAGCCGT -> GGTACTGCTTAAAGCCGTT
AGGTATAAGACATCAAGGA -> GGTATAAGACATCAAGGAA
AGGTATCGGGTAAGAAATT -> GGTATCGGGTAAGAAATTA
AGGTCACACGGGCAAAGTT -> GGTCACACGGGCAAAGTTG
AGGTCATCCACTCTTATCG -> GGTCATCCACTCTTATCGA
AGGTGCTATCAGAGAGCAT -> GGTGCTATCAGAGAGCATG
AGGTGTATTCATATAGGCG -> GGTGTATTCATATAGGCGA
AGTAAAACTGGTCAATCAA -> GTAAAACTGGTCAATCAAC
AGTAACAGTAAAACTGGTC -> GTAACAGTAAAACTGGTCA
AGTACCAGTAGACACTTCC -> GTACCAGTAGACACTTCCC
AGTACCCCCTAAGAAAGCT -> GTACCCCCTAAGAAAGCTT
AGTACGCGATAGGTATCGG -> GTACGCGATAGGTATCGGG
AGTACTTGTAAGCCCTCAA -> GTACTTGTAAGCCCTCAAT
AGTAGACACTTCCCGCCGT -> GTAGACACTTCCCGCCGTT
AGTAGACGCTTTAACATAG -> GTAGACGCTTTAACATAGA
AGTAGCAGTACCAGTAGAC -> GTAGCAGTACCAGTAGACA
AGTAGGAATTCCTATAACG -> GTAGGAATTCCTATAACGG
AGTAGGCTGTTTATCTCGC -> GTAGGCTGTTTATCTCGCA
AGTAGTGGCGTGAATGGTA -> GTAGTGGCGTGAATGGTAT
AGTAGTTATTCCTGCATTG -> GTAGTTATTCCTGCATTGG
AGTATCGCTGAAATAGTAC -> GTATCGCTGAAATAGTACT
AGTATTCAGAGACATTCTC -> GTATTCAGAGACATTCTCA
AGTCACTACGGTGGTGCAT -> GTCACTACGGTGGTGCATA
AGTCAGACCTGTTCAGCAA -> GTCAGACCTGTTCAGCAAG
AGTCCACATTGCCCGCTCG -> GTCCACATTGCCCGCTCGT
AGTCCACATTGCCGCAGTC -> GTCCACATTGCCGCAGTCG
AGTCCACATTGCCGTGCAG -> GTCCACATTGCCGTGCAGG
AGTCCACATTGCCTGACAT -> GTCCACATTGCCTGACATT
AGTCCAGCTTCAAGCAAGC -> GTCCAGCTTCAAGCAAGCA
AGTCCCCCGGTACTTATTC -> GTCCCCCGGTACTTATTCA
AGTCCCTATAATTTGGCAT -> GTCCCTATAATTTGGCATG
AGTCGAAAGCAAAGGGTTA -> GTCGAAAGCAAAGGGTTAA
AGTCTGCAAATATACTTTC -> GTCTGCAAATATACTTTCT
AGTGAGAGTCCCCCGGTAC -> GTGAGAGTCCCCCGGTACT
AGTGATGCGGTTGGACGCA -> GTGATGCGGTTGGACGCAC
AGTGCCCTTCTCAGAGCTA -> GTGCCCTTCTCAGAGCTAC
AGTGCGGATTGTCTTTACT -> GTGCGGATTGTCTTTACTT
AGTGCTGAGGCTTGTCTAG -> GTGCTGAGGCTTGTCTAGT
AGTGGCGTGAATGGTATGG -> GTGGCGTGAATGGTATGGT
AGTGTATAGTTGTCAAATG -> GTGTATAGTTGTCAAATGC
AGTGTGGATAAACCGGAGA -> GTGTGGATAAACCGGAGAC
AGTTACCCCCTTATGAGCA -> GTTACCCCCTTATGAGCAA
AGTTACTAACTTATTAGCA -> GTTACTAACTTATTAGCAA
AGTTAGCTATCCCGTGCAT -> GTTAGCTATCCCGTGCATG
AGTTATTCCTGCATTGGAA -> GTTATTCCTGCATTGGAAT
AGTTCACTGACAAAGTGCG -> GTTCACTGACAAAGTGCGG
AGTTGACGGCCAAGGATGC -> GTTGACGGCCAAGGATGCC
AGTTGCAGTAGTTATTCCT -> GTTGCAGTAGTTATTCCTG
AGTTGCTGGCTCCCGGAAG -> GTTGCTGGCTCCCGGAAGG
AGTTGGCAATCACACTGCC -> GTTGGCAATCACACTGCCA
AGTTGTCAAATGCCTAATA -> GTTGTCAAATGCCTAATAT
AGTTGTGGTTGAAATTCCA -> GTTGTGGTTGAAATTCCAA
ATAAACCGGAGACGTCTTA -> TAAACCGGAGACGTCTTAT
ATAAACTTCTGGTGTAACC -> TAAACTTCTGGTGTAACCG
ATAAAGTACCCCCTAAGAA -> TAAAGTACCCCCTAAGAAA
ATAAATGGTTAGCTGCACC -> TAAATGGTTAGCTGCACCG
ATAACCCGGAGTAGCAGTA -> TAACCCGGAGTAGCAGTAC
ATAACCCTCGCAGAGAACT -> TAACCCTCGCAGAGAACTC
ATAACGGGTGTGTCCCCAA -> TAACGGGTGTGTCCCCAAA
ATAAGACATCAAGGAATAA -> TAAGACATCAAGGAATAAG
ATAAGATTCCTGGAATCAT -> TAAGATTCCTGGAATCATA
ATAAGCTAGTCAGACCTGT -> TAAGCTAGTCAGACCTGTT
ATAAGTGATGCGGTTGGAC -> TAAGTGATGCGGTTGGACG
ATAATGCAAATGGCCTGGA -> TAATGCAAATGGCCTGGAA
ATAATGTTGGACAACAGCG -> TAATGTTGGACAACAGCGG
ATAATTACGGATCCGCTTG -> TAATTACGGATCCGCTTGT
ATAATTTGGCATGTGTTTC -> TAATTTGGCATGTGTTTCC
ATACCGCTTCTCCGTAGAC -> TACCGCTTCTCCGTAGACG
ATACCGTCCAGATTTTCAT -> TACCGTCCAGATTTTCATG
ATACCTAATTCTTCTGCGC -> TACCTAATTCTTCTGCGCT
ATACTACGATGGTCGGCGG -> TACTACGATGGTCGGCGGC
ATACTATAAGCTAGTCAGA -> TACTATAAGCTAGTCAGAC
ATACTCCTAATTGGACTTT -> TACTCCTAATTGGACTTTA
ATACTTTCTGGTTGTCCGA -> TACTTTCTGGTTGTCCGAA
ATAGAATATGTAAATTGAG -> TAGAATATGTAAATTGAGC
ATAGACTATAGTTGTGGTT -> TAGACTATAGTTGTGGTTG
ATAGCATGTGCGTTTTGAG -> TAGCATGTGCGTTTTGAGC
ATAGGCATTTGTAGACGCT -> TAGGCATTTGTAGACGCTT
ATAGGCGAAAACGTCCGTA -> TAGGCGAAAACGTCCGTAC
ATAGGTATCGGGTAAGAAA -> TAGGTATCGGGTAAGAAAT
ATAGTACTTGTAAGCCCTC -> TAGTACTTGTAAGCCCTCA
ATAGTAGACGCTTTAACAT -> TAGTAGACGCTTTAACATA
ATAGTAGGCTGTTTATCTC -> TAGTAGGCTGTTTATCTCG
ATAGTCCCTATAATTTGGC -> TAGTCCCTATAATTTGGCA
ATAGTTACCCCCTTATGAG -> TAGTTACCCCCTTATGAGC
ATAGTTGTCAAATGCCTAA -> TAGTTGTCAAATGCCTAAT
ATAGTTGTGGTTGAAATTC -> TAGTTGTGGTTGAAATTCC
ATATACTTTCTGGTTGTCC -> TATACTTTCTGGTTGTCCG
ATATAGGCGAAAACGTCCG -> TATAGGCGAAAACGTCCGT
ATATCCAAATAATGTTGGA -> TATCCAAATAATGTTGGAC
ATATCGATCCGGGAAGCCG -> TATCGATCCGGGAAGCCGC
ATATGTAAATTGAGCAAGT -> TATGTAAATTGAGCAAGTC
ATATTCCGGGATGTCCTAT -> TATTCCGGGATGTCCTATC
ATCAACAGGACCGGGTTCG -> TCAACAGGACCGGGTTCGT
ATCAACAGTACGCGATAGG -> TCAACAGTACGCGATAGGT
ATCAAGACGGTCTTTGGTC -> TCAAGACGGTCTTTGGTCC
ATCAAGATCTTGAAACAGA -> TCAAGATCTTGAAACAGAG
ATCAAGCAAATTAATAACC -> TCAAGCAAATTAATAACCC
ATCAAGGAATAAGATTCCT -> TCAAGGAATAAGATTCCTG
ATCAAGTTCACTGACAAAG -> TCAAGTTCACTGACAAAGT
ATCACACTGCCATAAGTGA -> TCACACTGCCATAAGTGAT
ATCACTCCCCGTGTCATGT -> TCACTCCCCGTGTCATGTG
ATCAGAGAGCATGTAAACC -> TCAGAGAGCATGTAAACCG
ATCATATTCCGGGATGTCC -> TCATATTCCGGGATGTCCT
ATCATGGAGTAGTGGCGTG -> TCATGGAGTAGTGGCGTGA
ATCCAAATAATGTTGGACA -> TCCAAATAATGTTGGACAA
ATCCACTCTTATCGAGTTG -> TCCACTCTTATCGAGTTGA
ATCCCGTGCATGGCGGATG -> TCCCGTGCATGGCGGATGC
ATCCGCATCGTAATGAAGG -> TCCGCATCGTAATGAAGGT
ATCCGCTTGTTGGGGGTAA -> TCCGCTTGTTGGGGGTAAG
ATCCGGGAAGCCGCACCTG -> TCCGGGAAGCCGCACCTGA
ATCGAGTTGACGGCCAAGG -> TCGAGTTGACGGCCAAGGA
ATCGATCCGGGAAGCCGCA -> TCGATCCGGGAAGCCGCAC
ATCGATGCGACAGGCGGAA -> TCGATGCGACAGGCGGAAC
ATCGCAAGGGTATGGAAAG -> TCGCAAGGGTATGGAAAGG
ATCGCTGAAATAGTACTTG -> TCGCTGAAATAGTACTTGT
ATCGGCAGATCGTGATCGC -> TCGGCAGATCGTGATCGCA
ATCGGCAGTCACTACGGTG -> TCGGCAGTCACTACGGTGG
ATCGGGTAAGAAATTATAA -> TCGGGTAAGAAATTATAAT
ATCGTAATGAAGGTCATCC -> TCGTAATGAAGGTCATCCA
ATCGTGATCGCAAGGGTAT -> TCGTGATCGCAAGGGTATG
ATCTCGCAAACGACCTTTG -> TCTCGCAAACGACCTTTGC
ATCTCTCGACAGCCCACTC -> TCTCTCGACAGCCCACTCC
ATCTTCCTCTCGCTTAACC -> TCTTCCTCTCGCTTAACCC
ATCTTGAAACAGAGGGGCG -> TCTTGAAACAGAGGGGCGT
ATGAACACCGGTTCATTCA -> TGAACACCGGTTCATTCAT
ATGAAGGTCATCCACTCTT -> TGAAGGTCATCCACTCTTA
ATGAGCAAGTCCACATTGC -> TGAGCAAGTCCACATTGCC
ATGCAAATGGCCTGGAAGT -> TGCAAATGGCCTGGAAGTC
ATGCAGATCATATTCCGGG -> TGCAGATCATATTCCGGGA
ATGCATTGGCGGCGGATTA -> TGCATTGGCGGCGGATTAG
ATGCCGGCGGTCAGACCTA -> TGCCGGCGGTCAGACCTAC
ATGCCTAATATCGATCCGG -> TGCCTAATATCGATCCGGG
ATGCGACAGGCGGAACCCG -> TGCGACAGGCGGAACCCGA
ATGCGAGTGTATAGTTGTC -> TGCGAGTGTATAGTTGTCA
ATGCGCGTACTTGGCCGAT -> TGCGCGTACTTGGCCGATT
ATGCGGTTGGACGCACATA -> TGCGGTTGGACGCACATAC
ATGCTCCGAGATCGATGCG -> TGCTCCGAGATCGATGCGA
ATGGAAAGGGCAGTAACAG -> TGGAAAGGGCAGTAACAGT
ATGGAGCTTGTTGGAAAGG -> TGGAGCTTGTTGGAAAGGA
ATGGAGTAGTGGCGTGAAT -> TGGAGTAGTGGCGTGAATG
ATGGCCTGGAAGTCCAGCT -> TGGCCTGGAAGTCCAGCTT
ATGGCGGATGCTCCGAGAT -> TGGCGGATGCTCCGAGATC
ATGGTATGGTCTAGAGTAT -> TGGTATGGTCTAGAGTATC
ATGGTCGGCGGCTGAGCCG -> TGGTCGGCGGCTGAGCCGC
ATGGTCTAGAGTATCGCTG -> TGGTCTAGAGTATCGCTGA
ATGGTTAACCTTAAAATTA -> TGGTTAACCTTAAAATTAG
ATGGTTAGCTGCACCGGAC -> TGGTTAGCTGCACCGGACA
ATGTAAACCGTCCCTTATT -> TGTAAACCGTCCCTTATTG
ATGTAAATTGAGCAAGTCC -> TGTAAATTGAGCAAGTCCA
ATGTAAGGTGCTATCAGAG -> TGTAAGGTGCTATCAGAGA
ATGTAATCAAGTTCACTGA -> TGTAATCAAGTTCACTGAC
ATGTACGCAGAAGACGACA -> TGTACGCAGAAGACGACAT
ATGTCCTATCTTCCTCTCG -> TGTCCTATCTTCCTCTCGC
ATGTGCGTTTTGAGCAAGT -> TGTGCGTTTTGAGCAAGTC
ATGTGTGGTCGGCATTACA -> TGTGTGGTCGGCATTACAT
ATGTGTTTCCACCCGAATA -> TGTGTTTCCACCCGAATAC
ATGTTGGACAACAGCGGTT -> TGTTGGACAACAGCGGTTC
ATTAATAACCCTCGCAGAG -> TTAATAACCCTCGCAGAGA
ATTAATGCGAGTGTATAGT -> TTAATGCGAGTGTATAGTT
ATTACATTCGTCCAGTGCC -> TTACATTCGTCCAGTGCCC
ATTACGGATCCGCTTGTTG -> TTACGGATCCGCTTGTTGG
ATTACTGGCATCAAGACGG -> TTACTGGCATCAAGACGGT
ATTAGATAGTAGGCTGTTT -> TTAGATAGTAGGCTGTTTA
ATTAGCAACCACAAATAAA -> TTAGCAACCACAAATAAAG
ATTAGGAAGTGAGAGTCCC -> TTAGGAAGTGAGAGTCCCC
ATTATAATTACGGATCCGC -> TTATAATTACGGATCCGCT
ATTATGTAATCAAGTTCAC -> TTATGTAATCAAGTTCACT
ATTCAAGGATGGTTAACCT -> TTCAAGGATGGTTAACCTT
ATTCACGCGCCCATCTCTC -> TTCACGCGCCCATCTCTCG
ATTCAGAGACATTCTCAGG -> TTCAGAGACATTCTCAGGC
ATTCAGGCTGAGGCCGTAA -> TTCAGGCTGAGGCCGTAAA
ATTCATAAACTTCTGGTGT -> TTCATAAACTTCTGGTGTA
ATTCATATAGGCGAAAACG -> TTCATATAGGCGAAAACGT
ATTCCAAGTATTCAGAGAC -> TTCCAAGTATTCAGAGACA
ATTCCGGGATGTCCTATCT -> TTCCGGGATGTCCTATCTT
ATTCCTATAACGGGTGTGT -> TTCCTATAACGGGTGTGTC
ATTCCTGCATTGGAATTTT -> TTCCTGCATTGGAATTTTG
ATTCCTGGAATCATACCCA -> TTCCTGGAATCATACCCAG
ATTCGCTGTCTACATAGTC -> TTCGCTGTCTACATAGTCC
ATTCGTCCAGTGCCCTTCT -> TTCGTCCAGTGCCCTTCTC
ATTCTCAGGCCAGAGCCTG -> TTCTCAGGCCAGAGCCTGG
ATTCTTCTGCGCTTAGGGT -> TTCTTCTGCGCTTAGGGTA
ATTGAATACCGCTTCTCCG -> TTGAATACCGCTTCTCCGT
ATTGAGCAAGTCCACATTG -> TTGAGCAAGTCCACATTGC,TTGAGCAAGTCCACATTGC
ATTGCATCGGCAGTCACTA -> TTGCATCGGCAGTCACTAC
ATTGCCCGCTCGTGAAAGC -> TTGCCCGCTCGTGAAAGCC
ATTGCCGCAGTCGAAAGCA -> TTGCCGCAGTCGAAAGCAA
ATTGCCGTGCAGGGCAGTT -> TTGCCGTGCAGGGCAGTTA
ATTGCCTGACATTGAGCAA -> TTGCCTGACATTGAGCAAG
ATTGGAATTTTGAATTCGC -> TTGGAATTTTGAATTCGCT
ATTGGACTTTAAATACTAT -> TTGGACTTTAAATACTATA
ATTGGCGGCGGATTAGGAA -> TTGGCGGCGGATTAGGAAG
ATTGGGTAAAGCTGCCTCT -> TTGGGTAAAGCTGCCTCTT
ATTGTAACACTTCTATAGA -> TTGTAACACTTCTATAGAC
ATTGTCTTTACTTGGGTGT -> TTGTCTTTACTTGGGTGTC
ATTTAGGCTGCAATGGAGC -> TTTAGGCTGCAATGGAGCT
ATTTGGCATGTGTTTCCAC -> TTTGGCATGTGTTTCCACC
ATTTGTAGACGCTTTAACA -> TTTGTAGACGCTTTAACAT
ATTTTCATGTAAGGTGCTA -> TTTTCATGTAAGGTGCTAT
ATTTTGAATTCGCTGTCTA -> TTTTGAATTCGCTGTCTAC
CAAAACGCTGCCGATGCAG -> AAAACGCTGCCGATGCAGA
CAAACGACCTTTGCGTTTG -> AAACGACCTTTGCGTTTGT
CAAAGGGTTAAAAGCGCGG -> AAAGGGTTAAAAGCGCGGA
CAAAGTGCGGATTGTCTTT -> AAAGTGCGGATTGTCTTTA
CAAAGTTGGCAATCACACT -> AAAGTTGGCAATCACACTG
CAAATAAAGTACCCCCTAA -> AAATAAAGTACCCCCTAAG
CAAATAACCCGGAGTAGCA -> AAATAACCCGGAGTAGCAG
CAAATAATGTTGGACAACA -> AAATAATGTTGGACAACAG
CAAATATACTTTCTGGTTG -> AAATATACTTTCTGGTTGT
CAAATCACTCCCCGTGTCA -> AAATCACTCCCCGTGTCAT
CAAATGCCTAATATCGATC -> AAATGCCTAATATCGATCC
CAAATGGCCTGGAAGTCCA -> AAATGGCCTGGAAGTCCAG
CAAATTAATAACCCTCGCA -> AAATTAATAACCCTCGCAG
CAACAGCGGTTCCAAGAAA -> AACAGCGGTTCCAAGAAAG
CAACAGGACCGGGTTCGTG -> AACAGGACCGGGTTCGTGG
CAACAGTACGCGATAGGTA -> AACAGTACGCGATAGGTAT
CAACCACAAATAAAGTACC -> AACCACAAATAAAGTACCC
CAAGAAAGGTATAAGACAT -> AAGAAAGGTATAAGACATC
CAAGACGGTCTTTGGTCCA -> AAGACGGTCTTTGGTCCAC
CAAGATCTTGAAACAGAGG -> AAGATCTTGAAACAGAGGG
CAAGCAAATTAATAACCCT -> AAGCAAATTAATAACCCTC
CAAGCAAGCAGCTGGGTTA -> AAGCAAGCAGCTGGGTTAG
CAAGCAGCTGGGTTAGTGT -> AAGCAGCTGGGTTAGTGTG
CAAGGAATAAGATTCCTGG -> AAGGAATAAGATTCCTGGA
CAAGGATGCCGGCGGTCAG -> AAGGATGCCGGCGGTCAGA
CAAGGATGGTTAACCTTAA -> AAGGATGGTTAACCTTAAA
CAAGGGTATGGAAAGGGCA -> AAGGGTATGGAAAGGGCAG
CAAGTATTCAGAGACATTC -> AAGTATTCAGAGACATTCT
CAAGTCCACATTGCCCGCT -> AAGTCCACATTGCCCGCTC
CAAGTCCACATTGCCGCAG -> AAGTCCACATTGCCGCAGT
CAAGTCCACATTGCCGTGC -> AAGTCCACATTGCCGTGCA
CAAGTCCACATTGCCTGAC -> AAGTCCACATTGCCTGACA
CAAGTTCACTGACAAAGTG -> AAGTTCACTGACAAAGTGC
CAAGTTGCTGGCTCCCGGA -> AAGTTGCTGGCTCCCGGAA
CAATCAACAGGACCGGGTT -> AATCAACAGGACCGGGTTC
CAATCAAGCAAATTAATAA -> AATCAAGCAAATTAATAAC
CAATCACACTGCCATAAGT -> AATCACACTGCCATAAGTG
CAATGCATTGGCGGCGGAT -> AATGCATTGGCGGCGGATT
CAATGGAGCTTGTTGGAAA -> AATGGAGCTTGTTGGAAAG
CAATTGCATCGGCAGTCAC -> AATTGCATCGGCAGTCACT
CACAAATAAAGTACCCCCT -> ACAAATAAAGTACCCCCTA
CACACGGGCAAAGTTGGCA -> ACACGGGCAAAGTTGGCAA
CACACTGCCATAAGTGATG -> ACACTGCCATAAGTGATGC
CACATACCGTCCAGATTTT -> ACATACCGTCCAGATTTTC
CACATTGCCCGCTCGTGAA -> ACATTGCCCGCTCGTGAAA
CACATTGCCGCAGTCGAAA -> ACATTGCCGCAGTCGAAAG
CACATTGCCGTGCAGGGCA -> ACATTGCCGTGCAGGGCAG
CACATTGCCTGACATTGAG -> ACATTGCCTGACATTGAGC
CACCCGAATACCTAATTCT -> ACCCGAATACCTAATTCTT
CACCGGACACGAAGACAAT -> ACCGGACACGAAGACAATC
CACCGGTTCATTCATAAAC -> ACCGGTTCATTCATAAACT
CACCTGAGAAAGTTGCAGT -> ACCTGAGAAAGTTGCAGTA
CACGAAGACAATCAAGCAA -> ACGAAGACAATCAAGCAAA
CACGACATTGGGTAAAGCT -> ACGACATTGGGTAAAGCTG
CACGCGCCCATCTCTCGAC -> ACGCGCCCATCTCTCGACA
CACGGGCAAAGTTGGCAAT -> ACGGGCAAAGTTGGCAATC
CACTACGGTGGTGCATATC -> ACTACGGTGGTGCATATCC
CACTAGTTAGCTATCCCGT -> ACTAGTTAGCTATCCCGTG
CACTCCAGAAGGGGCGCTA -> ACTCCAGAAGGGGCGCTAT
CACTCCCCGTGTCATGTGT -> ACTCCCCGTGTCATGTGTG
CACTCTTATCGAGTTGACG -> ACTCTTATCGAGTTGACGG
CACTGACAAAGTGCGGATT -> ACTGACAAAGTGCGGATTG
CACTGCCATAAGTGATGCG -> ACTGCCATAAGTGATGCGG
CACTTCCCGCCGTTAAACC -> ACTTCCCGCCGTTAAACCA
CACTTCTATAGACTATAGT -> ACTTCTATAGACTATAGTT
CAGAAGACGACATTGAATA -> AGAAGACGACATTGAATAC
CAGAAGGGGCGCTATCGGC -> AGAAGGGGCGCTATCGGCA
CAGACCTACTTGAATAGTA -> AGACCTACTTGAATAGTAG
CAGACCTGTTCAGCAAGTT -> AGACCTGTTCAGCAAGTTG
CAGAGAACTCTTCTTTCGG -> AGAGAACTCTTCTTTCGGA
CAGAGACATTCTCAGGCCA -> AGAGACATTCTCAGGCCAG
CAGAGAGCATGTAAACCGT -> AGAGAGCATGTAAACCGTC
CAGAGCCTGGGGTCCGCCG -> AGAGCCTGGGGTCCGCCGT
CAGAGCTACCCAATTGCAT -> AGAGCTACCCAATTGCATC
CAGAGGGGCGTGCCCGAGG -> AGAGGGGCGTGCCCGAGGC
CAGATCATATTCCGGGATG -> AGATCATATTCCGGGATGT
CAGATCGTGATCGCAAGGG -> AGATCGTGATCGCAAGGGT
CAGATTTTCATGTAAGGTG -> AGATTTTCATGTAAGGTGC
CAGCAAGTTGCTGGCTCCC -> AGCAAGTTGCTGGCTCCCG
CAGCCCACTCCAGAAGGGG -> AGCCCACTCCAGAAGGGGC
CAGCGGTTCCAAGAAAGGT -> AGCGGTTCCAAGAAAGGTA
CAGCTAAAGCGGCCCTCTA -> AGCTAAAGCGGCCCTCTAC
CAGCTGGGTTAGTGTGGAT -> AGCTGGGTTAGTGTGGATA
CAGCTTCAAGCAAGCAGCT -> AGCTTCAAGCAAGCAGCTG
CAGGACCGGGTTCGTGGCA -> AGGACCGGGTTCGTGGCAG
CAGGCCAGAGCCTGGGGTC -> AGGCCAGAGCCTGGGGTCC
CAGGCGGAACCCGAGCCCT -> AGGCGGAACCCGAGCCCTC
CAGGCTGAGGCCGTAAAGG -> AGGCTGAGGCCGTAAAGGT
CAGGGCAGTTACTAACTTA -> AGGGCAGTTACTAACTTAT
CAGGTCACACGGGCAAAGT -> AGGTCACACGGGCAAAGTT
CAGTAAAACTGGTCAATCA -> AGTAAAACTGGTCAATCAA
CAGTAACAGTAAAACTGGT -> AGTAACAGTAAAACTGGTC
CAGTACCAGTAGACACTTC -> AGTACCAGTAGACACTTCC
CAGTACGCGATAGGTATCG -> AGTACGCGATAGGTATCGG
CAGTAGACACTTCCCGCCG -> AGTAGACACTTCCCGCCGT
CAGTAGGAATTCCTATAAC -> AGTAGGAATTCCTATAACG
CAGTAGTTATTCCTGCATT -> AGTAGTTATTCCTGCATTG
CAGTCACTACGGTGGTGCA -> AGTCACTACGGTGGTGCAT
CAGTCGAAAGCAAAGGGTT -> AGTCGAAAGCAAAGGGTTA
CAGTGCCCTTCTCAGAGCT -> AGTGCCCTTCTCAGAGCTA
CAGTGCTGAGGCTTGTCTA -> AGTGCTGAGGCTTGTCTAG
CAGTTACTAACTTATTAGC -> AGTTACTAACTTATTAGCA
CATAAACTTCTGGTGTAAC -> ATAAACTTCTGGTGTAACC
CATAAGTGATGCGGTTGGA -> ATAAGTGATGCGGTTGGAC
CATAATGCAAATGGCCTGG -> ATAATGCAAATGGCCTGGA
CATACCGTCCAGATTTTCA -> ATACCGTCCAGATTTTCAT
CATACTACGATGGTCGGCG -> ATACTACGATGGTCGGCGG
CATACTCCTAATTGGACTT -> ATACTCCTAATTGGACTTT
CATAGAATATGTAAATTGA -> ATAGAATATGTAAATTGAG
CATAGCATGTGCGTTTTGA -> ATAGCATGTGCGTTTTGAG
CATAGGCATTTGTAGACGC -> ATAGGCATTTGTAGACGCT
CATAGTCCCTATAATTTGG -> ATAGTCCCTATAATTTGGC
CATAGTTACCCCCTTATGA -> ATAGTTACCCCCTTATGAG
CATATAGGCGAAAACGTCC -> ATATAGGCGAAAACGTCCG
CATATCCAAATAATGTTGG -> ATATCCAAATAATGTTGGA
CATATTCCGGGATGTCCTA -> ATATTCCGGGATGTCCTAT
CATCAAGACGGTCTTTGGT -> ATCAAGACGGTCTTTGGTC
CATCAAGGAATAAGATTCC -> ATCAAGGAATAAGATTCCT
CATCCACTCTTATCGAGTT -> ATCCACTCTTATCGAGTTG
CATCGGCAGTCACTACGGT -> ATCGGCAGTCACTACGGTG
CATCGTAATGAAGGTCATC -> ATCGTAATGAAGGTCATCC
CATCTCTCGACAGCCCACT -> ATCTCTCGACAGCCCACTC
CATGAACACCGGTTCATTC -> ATGAACACCGGTTCATTCA
CATGGAGTAGTGGCGTGAA -> ATGGAGTAGTGGCGTGAAT
CATGGCGGATGCTCCGAGA -> ATGGCGGATGCTCCGAGAT
CATGTAAACCGTCCCTTAT -> ATGTAAACCGTCCCTTATT
CATGTAAGGTGCTATCAGA -> ATGTAAGGTGCTATCAGAG
CATGTGCGTTTTGAGCAAG -> ATGTGCGTTTTGAGCAAGT
CATGTGTGGTCGGCATTAC -> ATGTGTGGTCGGCATTACA
CATGTGTTTCCACCCGAAT -> ATGTGTTTCCACCCGAATA
CATTACATTCGTCCAGTGC -> ATTACATTCGTCCAGTGCC
CATTCATAAACTTCTGGTG -> ATTCATAAACTTCTGGTGT
CATTCGTCCAGTGCCCTTC -> ATTCGTCCAGTGCCCTTCT
CATTCTCAGGCCAGAGCCT -> ATTCTCAGGCCAGAGCCTG
CATTGAATACCGCTTCTCC -> ATTGAATACCGCTTCTCCG
CATTGAGCAAGTCCACATT -> ATTGAGCAAGTCCACATTG
CATTGCCCGCTCGTGAAAG -> ATTGCCCGCTCGTGAAAGC
CATTGCCGCAGTCGAAAGC -> ATTGCCGCAGTCGAAAGCA
CATTGCCGTGCAGGGCAGT -> ATTGCCGTGCAGGGCAGTT
CATTGCCTGACATTGAGCA -> ATTGCCTGACATTGAGCAA
CATTGGAATTTTGAATTCG -> ATTGGAATTTTGAATTCGC
CATTGGCGGCGGATTAGGA -> ATTGGCGGCGGATTAGGAA
CATTGGGTAAAGCTGCCTC -> ATTGGGTAAAGCTGCCTCT
CATTTGTAGACGCTTTAAC -> ATTTGTAGACGCTTTAACA
CCAAAACGCTGCCGATGCA -> CAAAACGCTGCCGATGCAG
CCAAATAACCCGGAGTAGC -> CAAATAACCCGGAGTAGCA
CCAAATAATGTTGGACAAC -> CAAATAATGTTGGACAACA
CCAAGAAAGGTATAAGACA -> CAAGAAAGGTATAAGACAT
CCAAGGATGCCGGCGGTCA -> CAAGGATGCCGGCGGTCAG
CCAAGTATTCAGAGACATT -> CAAGTATTCAGAGACATTC
CCAATTGCATCGGCAGTCA -> CAATTGCATCGGCAGTCAC
CCACAAATAAAGTACCCCC -> CACAAATAAAGTACCCCCT
CCACATTGCCCGCTCGTGA -> CACATTGCCCGCTCGTGAA
CCACATTGCCGCAGTCGAA -> CACATTGCCGCAGTCGAAA
CCACATTGCCGTGCAGGGC -> CACATTGCCGTGCAGGGCA
CCACATTGCCTGACATTGA -> CACATTGCCTGACATTGAG
CCACCCGAATACCTAATTC -> CACCCGAATACCTAATTCT
CCACTAGTTAGCTATCCCG -> CACTAGTTAGCTATCCCGT
CCACTCCAGAAGGGGCGCT -> CACTCCAGAAGGGGCGCTA
CCACTCTTATCGAGTTGAC -> CACTCTTATCGAGTTGACG
CCAGAAGGGGCGCTATCGG -> CAGAAGGGGCGCTATCGGC
CCAGAGCCTGGGGTCCGCC -> CAGAGCCTGGGGTCCGCCG
CCAGATTTTCATGTAAGGT -> CAGATTTTCATGTAAGGTG
CCAGCTAAAGCGGCCCTCT -> CAGCTAAAGCGGCCCTCTA
CCAGCTTCAAGCAAGCAGC -> CAGCTTCAAGCAAGCAGCT
CCAGGTCACACGGGCAAAG -> CAGGTCACACGGGCAAAGT
CCAGTAGACACTTCCCGCC -> CAGTAGACACTTCCCGCCG
CCAGTGCCCTTCTCAGAGC -> CAGTGCCCTTCTCAGAGCT
CCATAAGTGATGCGGTTGG -> CATAAGTGATGCGGTTGGA
CCATCTCTCGACAGCCCAC -> CATCTCTCGACAGCCCACT
CCCAAAACGCTGCCGATGC -> CCAAAACGCTGCCGATGCA
CCCAATTGCATCGGCAGTC -> CCAATTGCATCGGCAGTCA
CCCACTCCAGAAGGGGCGC -> CCACTCCAGAAGGGGCGCT
CCCAGCTAAAGCGGCCCTC -> CCAGCTAAAGCGGCCCTCT
CCCATCTCTCGACAGCCCA -> CCATCTCTCGACAGCCCAC
CCCCAAAACGCTGCCGATG -> CCCAAAACGCTGCCGATGC
CCCCCGGTACTTATTCAGG -> CCCCGGTACTTATTCAGGC
CCCCCTAAGAAAGCTTAAC -> CCCCTAAGAAAGCTTAACC
CCCCCTTATGAGCAAGTCC -> CCCCTTATGAGCAAGTCCA
CCCCGGTACTTATTCAGGC -> CCCGGTACTTATTCAGGCT
CCCCGTGTCATGTGTGGTC -> CCCGTGTCATGTGTGGTCG
CCCCTAAGAAAGCTTAACC -> CCCTAAGAAAGCTTAACCT
CCCCTTATGAGCAAGTCCA -> CCCTTATGAGCAAGTCCAC
CCCGAATACCTAATTCTTC -> CCGAATACCTAATTCTTCT
CCCGAGCCCTCATACTACG -> CCGAGCCCTCATACTACGA
CCCGAGGCGTGGCATGAAC -> CCGAGGCGTGGCATGAACA
CCCGCCGTTAAACCAGGTC -> CCGCCGTTAAACCAGGTCA
CCCGCTCGTGAAAGCCCTT -> CCGCTCGTGAAAGCCCTTT
CCCGGAAGGATAAATGGTT -> CCGGAAGGATAAATGGTTA
CCCGGAGTAGCAGTACCAG -> CCGGAGTAGCAGTACCAGT
CCCGGTACTTATTCAGGCT -> CCGGTACTTATTCAGGCTG
CCCGTGCATGGCGGATGCT -> CCGTGCATGGCGGATGCTC
CCCGTGTCATGTGTGGTCG -> CCGTGTCATGTGTGGTCGG
CCCTAAGAAAGCTTAACCT -> CCTAAGAAAGCTTAACCTA
CCCTATAATTTGGCATGTG -> CCTATAATTTGGCATGTGT
CCCTATTTAGGCTGCAATG -> CCTATTTAGGCTGCAATGG
CCCTCAATGCATTGGCGGC -> CCTCAATGCATTGGCGGCG
CCCTCATACTACGATGGTC -> CCTCATACTACGATGGTCG
CCCTCGCAGAGAACTCTTC -> CCTCGCAGAGAACTCTTCT
CCCTCTACTGGTAATGTAC -> CCTCTACTGGTAATGTACG
CCCTTATGAGCAAGTCCAC -> CCTTATGAGCAAGTCCACA
CCCTTATTGTAACACTTCT -> CCTTATTGTAACACTTCTA
CCCTTCTCAGAGCTACCCA -> CCTTCTCAGAGCTACCCAA
CCCTTTCAAATCACTCCCC -> CCTTTCAAATCACTCCCCG
CCGAATACCTAATTCTTCT -> CGAATACCTAATTCTTCTG
CCGAATTACTGGCATCAAG -> CGAATTACTGGCATCAAGA
CCGAGATCGATGCGACAGG -> CGAGATCGATGCGACAGGC
CCGAGCCCTCATACTACGA -> CGAGCCCTCATACTACGAT
CCGAGGCGTGGCATGAACA -> CGAGGCGTGGCATGAACAC
CCGATGCAGATCATATTCC -> CGATGCAGATCATATTCCG
CCGATTATGTAATCAAGTT -> CGATTATGTAATCAAGTTC
CCGCACCTGAGAAAGTTGC -> CGCACCTGAGAAAGTTGCA
CCGCAGTCGAAAGCAAAGG -> CGCAGTCGAAAGCAAAGGG
CCGCATCGTAATGAAGGTC -> CGCATCGTAATGAAGGTCA
CCGCCCAGCTAAAGCGGCC -> CGCCCAGCTAAAGCGGCCC
CCGCCGTATCATGGAGTAG -> CGCCGTATCATGGAGTAGT
CCGCCGTTAAACCAGGTCA -> CGCCGTTAAACCAGGTCAC
CCGCTCGTGAAAGCCCTTT -> CGCTCGTGAAAGCCCTTTC
CCGCTGGCCAAATAACCCG -> CGCTGGCCAAATAACCCGG
CCGCTTCTCCGTAGACGCT -> CGCTTCTCCGTAGACGCTT
CCGCTTGTTGGGGGTAAGA -> CGCTTGTTGGGGGTAAGAC
CCGGAAGGATAAATGGTTA -> CGGAAGGATAAATGGTTAG
CCGGACACGAAGACAATCA -> CGGACACGAAGACAATCAA
CCGGAGACGTCTTATTAAT -> CGGAGACGTCTTATTAATG
CCGGAGTAGCAGTACCAGT -> CGGAGTAGCAGTACCAGTA
CCGGCGGTCAGACCTACTT -> CGGCGGTCAGACCTACTTG
CCGGGAAGCCGCACCTGAG -> CGGGAAGCCGCACCTGAGA
CCGGGATGTCCTATCTTCC -> CGGGATGTCCTATCTTCCT
CCGGGTTCGTGGCAGTAGG -> CGGGTTCGTGGCAGTAGGA
CCGGTACTTATTCAGGCTG -> CGGTACTTATTCAGGCTGA
CCGGTTCATTCATAAACTT -> CGGTTCATTCATAAACTTC
CCGTAAAGGTGTATTCATA -> CGTAAAGGTGTATTCATAT
CCGTACTGGCCTGGTAGAC -> CGTACTGGCCTGGTAGACG
CCGTAGACGCTTTAACATA -> CGTAGACGCTTTAACATAG
CCGTATCATGGAGTAGTGG -> CGTATCATGGAGTAGTGGC
CCGTCCAGATTTTCATGTA -> CGTCCAGATTTTCATGTAA
CCGTCCCTTATTGTAACAC -> CGTCCCTTATTGTAACACT
CCGTGCAGGGCAGTTACTA -> CGTGCAGGGCAGTTACTAA
CCGTGCATGGCGGATGCTC -> CGTGCATGGCGGATGCTCC
CCGTGTCATGTGTGGTCGG -> CGTGTCATGTGTGGTCGGC
CCGTTAAACCAGGTCACAC -> CGTTAAACCAGGTCACACG
CCGTTCATACTCCTAATTG -> CGTTCATACTCCTAATTGG
CCTAAGAAAGCTTAACCTA -> CTAAGAAAGCTTAACCTAC
CCTAATATCGATCCGGGAA -> CTAATATCGATCCGGGAAG
CCTAATTCTTCTGCGCTTA -> CTAATTCTTCTGCGCTTAG
CCTAATTGGACTTTAAATA -> CTAATTGGACTTTAAATAC
CCTACAGTGCTGAGGCTTG -> CTACAGTGCTGAGGCTTGT
CCTACTTGAATAGTAGACG -> CTACTTGAATAGTAGACGC
CCTATAACGGGTGTGTCCC -> CTATAACGGGTGTGTCCCC
CCTATAATTTGGCATGTGT -> CTATAATTTGGCATGTGTT
CCTATCTTCCTCTCGCTTA -> CTATCTTCCTCTCGCTTAA
CCTATTTAGGCTGCAATGG -> CTATTTAGGCTGCAATGGA
CCTCAATGCATTGGCGGCG -> CTCAATGCATTGGCGGCGG
CCTCATACTACGATGGTCG -> CTCATACTACGATGGTCGG
CCTCGCAGAGAACTCTTCT -> CTCGCAGAGAACTCTTCTT
CCTCTACTGGTAATGTACG -> CTCTACTGGTAATGTACGC
CCTCTCGCTTAACCCTATT -> CTCTCGCTTAACCCTATTT
CCTCTTGACTATCCGCATC -> CTCTTGACTATCCGCATCG
CCTGACATTGAGCAAGTCC -> CTGACATTGAGCAAGTCCA
CCTGAGAAAGTTGCAGTAG -> CTGAGAAAGTTGCAGTAGT
CCTGCATTGGAATTTTGAA -> CTGCATTGGAATTTTGAAT
CCTGGAAGTCCAGCTTCAA -> CTGGAAGTCCAGCTTCAAG
CCTGGAATCATACCCAGCG -> CTGGAATCATACCCAGCGC
CCTGGGGTCCGCCGTATCA -> CTGGGGTCCGCCGTATCAT
CCTGGTAGACGCTTTAACA -> CTGGTAGACGCTTTAACAT
CCTGTTCAGCAAGTTGCTG -> CTGTTCAGCAAGTTGCTGG
CCTTAAAATTAGATAGTAG -> CTTAAAATTAGATAGTAGG
CCTTATGAGCAAGTCCACA -> CTTATGAGCAAGTCCACAT
CCTTATTGTAACACTTCTA -> CTTATTGTAACACTTCTAT
CCTTCTCAGAGCTACCCAA -> CTTCTCAGAGCTACCCAAT
CCTTTCAAATCACTCCCCG -> CTTTCAAATCACTCCCCGT
CCTTTGCGTTTGTTGCATA -> CTTTGCGTTTGTTGCATAA
CGAAAACGTCCGTACTGGC -> GAAAACGTCCGTACTGGCC
CGAAAGCAAAGGGTTAAAA -> GAAAGCAAAGGGTTAAAAG
CGAAGACAATCAAGCAAAT -> GAAGACAATCAAGCAAATT
CGAATACCTAATTCTTCTG -> GAATACCTAATTCTTCTGC
CGAATCAAGATCTTGAAAC -> GAATCAAGATCTTGAAACA
CGAATTACTGGCATCAAGA -> GAATTACTGGCATCAAGAC
CGACAGCCCACTCCAGAAG -> GACAGCCCACTCCAGAAGG
CGACAGGCGGAACCCGAGC -> GACAGGCGGAACCCGAGCC
CGACATTGAATACCGCTTC -> GACATTGAATACCGCTTCT
CGACATTGGGTAAAGCTGC -> GACATTGGGTAAAGCTGCC
CGACCTTTGCGTTTGTTGC -> GACCTTTGCGTTTGTTGCA
CGAGATCGATGCGACAGGC -> GAGATCGATGCGACAGGCG
CGAGCCCTCATACTACGAT -> GAGCCCTCATACTACGATG
CGAGGCGTGGCATGAACAC -> GAGGCGTGGCATGAACACC
CGAGGCTCACGACATTGGG -> GAGGCTCACGACATTGGGT
CGAGTGTATAGTTGTCAAA -> GAGTGTATAGTTGTCAAAT
CGAGTTGACGGCCAAGGAT -> GAGTTGACGGCCAAGGATG
CGATAGGTATCGGGTAAGA -> GATAGGTATCGGGTAAGAA
CGATCCGGGAAGCCGCACC -> GATCCGGGAAGCCGCACCT
CGATGCAGATCATATTCCG -> GATGCAGATCATATTCCGG
CGATGCGACAGGCGGAACC -> GATGCGACAGGCGGAACCC
CGATGGTCGGCGGCTGAGC -> GATGGTCGGCGGCTGAGCC
CGATTATGTAATCAAGTTC -> GATTATGTAATCAAGTTCA
CGCAAACGACCTTTGCGTT -> GCAAACGACCTTTGCGTTT
CGCAAGGGTATGGAAAGGG -> GCAAGGGTATGGAAAGGGC
CGCACATACCGTCCAGATT -> GCACATACCGTCCAGATTT
CGCACCTGAGAAAGTTGCA -> GCACCTGAGAAAGTTGCAG
CGCAGAAGACGACATTGAA -> GCAGAAGACGACATTGAAT
CGCAGAGAACTCTTCTTTC -> GCAGAGAACTCTTCTTTCG
CGCAGTCGAAAGCAAAGGG -> GCAGTCGAAAGCAAAGGGT
CGCATCGTAATGAAGGTCA -> GCATCGTAATGAAGGTCAT
CGCCCAGCTAAAGCGGCCC -> GCCCAGCTAAAGCGGCCCT
CGCCCATCTCTCGACAGCC -> GCCCATCTCTCGACAGCCC
CGCCGTATCATGGAGTAGT -> GCCGTATCATGGAGTAGTG
CGCCGTTAAACCAGGTCAC -> GCCGTTAAACCAGGTCACA
CGCGATAGGTATCGGGTAA -> GCGATAGGTATCGGGTAAG
CGCGCCCATCTCTCGACAG -> GCGCCCATCTCTCGACAGC
CGCGGAGGTACTGCTTAAA -> GCGGAGGTACTGCTTAAAG
CGCGTACTTGGCCGATTAT -> GCGTACTTGGCCGATTATG
CGCTATCGGCAGATCGTGA -> GCTATCGGCAGATCGTGAT
CGCTCGTGAAAGCCCTTTC -> GCTCGTGAAAGCCCTTTCA
CGCTGAAATAGTACTTGTA -> GCTGAAATAGTACTTGTAA
CGCTGCCGATGCAGATCAT -> GCTGCCGATGCAGATCATA
CGCTGGCCAAATAACCCGG -> GCTGGCCAAATAACCCGGA
CGCTGTCTACATAGTCCCT -> GCTGTCTACATAGTCCCTA
CGCTTAACCCTATTTAGGC -> GCTTAACCCTATTTAGGCT
CGCTTAGGGTATCAACAGT -> GCTTAGGGTATCAACAGTA
CGCTTCTCCGTAGACGCTT -> GCTTCTCCGTAGACGCTTT
CGCTTGTTGGGGGTAAGAC -> GCTTGTTGGGGGTAAGACG
CGCTTTAACATAGAATATG -> GCTTTAACATAGAATATGT
CGCTTTAACATAGCATGTG -> GCTTTAACATAGCATGTGC
CGCTTTAACATAGGCATTT -> GCTTTAACATAGGCATTTG
CGCTTTAACATAGTTACCC -> GCTTTAACATAGTTACCCC
CGGAACCCGAGCCCTCATA -> GGAACCCGAGCCCTCATAC
CGGAAGGATAAATGGTTAG -> GGAAGGATAAATGGTTAGC
CGGACACGAAGACAATCAA -> GGACACGAAGACAATCAAG
CGGAGACGTCTTATTAATG -> GGAGACGTCTTATTAATGC
CGGAGGTACTGCTTAAAGC -> GGAGGTACTGCTTAAAGCC
CGGAGTAGCAGTACCAGTA -> GGAGTAGCAGTACCAGTAG
CGGATCCGCTTGTTGGGGG -> GGATCCGCTTGTTGGGGGT
CGGATGCTCCGAGATCGAT -> GGATGCTCCGAGATCGATG
CGGATTAGGAAGTGAGAGT -> GGATTAGGAAGTGAGAGTC
CGGATTCACGCGCCCATCT -> GGATTCACGCGCCCATCTC
CGGATTGTCTTTACTTGGG -> GGATTGTCTTTACTTGGGT
CGGCAGATCGTGATCGCAA -> GGCAGATCGTGATCGCAAG
CGGCAGTCACTACGGTGGT -> GGCAGTCACTACGGTGGTG
CGGCATTACATTCGTCCAG -> GGCATTACATTCGTCCAGT
CGGCCAAGGATGCCGGCGG -> GGCCAAGGATGCCGGCGGT
CGGCCCTCTACTGGTAATG -> GGCCCTCTACTGGTAATGT
CGGCGGATTAGGAAGTGAG -> GGCGGATTAGGAAGTGAGA
CGGCGGCTGAGCCGCCCAG -> GGCGGCTGAGCCGCCCAGC
CGGCGGTCAGACCTACTTG -> GGCGGTCAGACCTACTTGA
CGGCTGAGCCGCCCAGCTA -> GGCTGAGCCGCCCAGCTAA
CGGGAAGCCGCACCTGAGA -> GGGAAGCCGCACCTGAGAA
CGGGATGTCCTATCTTCCT -> GGGATGTCCTATCTTCCTC
CGGGCAAAGTTGGCAATCA -> GGGCAAAGTTGGCAATCAC
CGGGTAAGAAATTATAATT -> GGGTAAGAAATTATAATTA
CGGGTGTGTCCCCAAAACG -> GGGTGTGTCCCCAAAACGC
CGGGTTCGTGGCAGTAGGA -> GGGTTCGTGGCAGTAGGAA
CGGTACTTATTCAGGCTGA -> GGTACTTATTCAGGCTGAG
CGGTCAGACCTACTTGAAT -> GGTCAGACCTACTTGAATA
CGGTCTTTGGTCCACTAGT -> GGTCTTTGGTCCACTAGTT
CGGTGGTGCATATCCAAAT -> GGTGGTGCATATCCAAATA
CGGTTCATTCATAAACTTC -> GGTTCATTCATAAACTTCT
CGGTTCCAAGAAAGGTATA -> GGTTCCAAGAAAGGTATAA
CGGTTGGACGCACATACCG -> GGTTGGACGCACATACCGT
CGTAAAGGTGTATTCATAT -> GTAAAGGTGTATTCATATA
CGTAATGAAGGTCATCCAC -> GTAATGAAGGTCATCCACT
CGTACTGGCCTGGTAGACG -> GTACTGGCCTGGTAGACGC
CGTACTTGGCCGATTATGT -> GTACTTGGCCGATTATGTA
CGTAGACGCTTTAACATAG -> GTAGACGCTTTAACATAGC
CGTATCATGGAGTAGTGGC -> GTATCATGGAGTAGTGGCG
CGTATTCAAGGATGGTTAA -> GTATTCAAGGATGGTTAAC
CGTCCAGATTTTCATGTAA -> GTCCAGATTTTCATGTAAG
CGTCCAGTGCCCTTCTCAG -> GTCCAGTGCCCTTCTCAGA
CGTCCCTTATTGTAACACT -> GTCCCTTATTGTAACACTT
CGTCCGTACTGGCCTGGTA -> GTCCGTACTGGCCTGGTAG
CGTCTTATTAATGCGAGTG -> GTCTTATTAATGCGAGTGT
CGTGAAAGCCCTTTCAAAT -> GTGAAAGCCCTTTCAAATC
CGTGAATGGTATGGTCTAG -> GTGAATGGTATGGTCTAGA
CGTGATCGCAAGGGTATGG -> GTGATCGCAAGGGTATGGA
CGTGCAGGGCAGTTACTAA -> GTGCAGGGCAGTTACTAAC
CGTGCATGGCGGATGCTCC -> GTGCATGGCGGATGCTCCG
CGTGCCCGAGGCGTGGCAT -> GTGCCCGAGGCGTGGCATG
CGTGGCAGTAGGAATTCCT -> GTGGCAGTAGGAATTCCTA
CGTGGCATGAACACCGGTT -> GTGGCATGAACACCGGTTC
CGTGTCATGTGTGGTCGGC -> GTGTCATGTGTGGTCGGCA
CGTTAAACCAGGTCACACG -> GTTAAACCAGGTCACACGG
CGTTCATACTCCTAATTGG -> GTTCATACTCCTAATTGGA
CGTTTGTTGCATAATGCAA -> GTTTGTTGCATAATGCAAA
CGTTTTGAGCAAGTCCACA -> GTTTTGAGCAAGTCCACAT
CTAAAGCGGCCCTCTACTG -> TAAAGCGGCCCTCTACTGG
CTAACTTATTAGCAACCAC -> TAACTTATTAGCAACCACA
CTAAGAAAGCTTAACCTAC -> TAAGAAAGCTTAACCTACA
CTAATATCGATCCGGGAAG -> TAATATCGATCCGGGAAGC
CTAATTCTTCTGCGCTTAG -> TAATTCTTCTGCGCTTAGG
CTAATTGGACTTTAAATAC -> TAATTGGACTTTAAATACT
CTACAGTGCTGAGGCTTGT -> TACAGTGCTGAGGCTTGTC
CTACATAGTCCCTATAATT -> TACATAGTCCCTATAATTT
CTACCCAATTGCATCGGCA -> TACCCAATTGCATCGGCAG
CTACGATGGTCGGCGGCTG -> TACGATGGTCGGCGGCTGA
CTACGGTGGTGCATATCCA -> TACGGTGGTGCATATCCAA
CTACTGGTAATGTACGCAG -> TACTGGTAATGTACGCAGA
CTACTTGAATAGTAGACGC -> TACTTGAATAGTAGACGCT
CTAGAGTATCGCTGAAATA -> TAGAGTATCGCTGAAATAG
CTAGTCAGACCTGTTCAGC -> TAGTCAGACCTGTTCAGCA
CTAGTCTGCAAATATACTT -> TAGTCTGCAAATATACTTT
CTAGTTAGCTATCCCGTGC -> TAGTTAGCTATCCCGTGCA
CTATAACGGGTGTGTCCCC -> TATAACGGGTGTGTCCCCA
CTATAAGCTAGTCAGACCT -> TATAAGCTAGTCAGACCTG
CTATAATTTGGCATGTGTT -> TATAATTTGGCATGTGTTT
CTATAGACTATAGTTGTGG -> TATAGACTATAGTTGTGGT
CTATAGTTGTGGTTGAAAT -> TATAGTTGTGGTTGAAATT
CTATCAGAGAGCATGTAAA -> TATCAGAGAGCATGTAAAC
CTATCCCGTGCATGGCGGA -> TATCCCGTGCATGGCGGAT
CTATCCGCATCGTAATGAA -> TATCCGCATCGTAATGAAG
CTATCGGCAGATCGTGATC -> TATCGGCAGATCGTGATCG
CTATCTTCCTCTCGCTTAA -> TATCTTCCTCTCGCTTAAC
CTATTTAGGCTGCAATGGA -> TATTTAGGCTGCAATGGAG
CTCAATGCATTGGCGGCGG -> TCAATGCATTGGCGGCGGA
CTCACGACATTGGGTAAAG -> TCACGACATTGGGTAAAGC
CTCAGAGCTACCCAATTGC -> TCAGAGCTACCCAATTGCA
CTCAGGCCAGAGCCTGGGG -> TCAGGCCAGAGCCTGGGGT
CTCATACTACGATGGTCGG -> TCATACTACGATGGTCGGC
CTCCAGAAGGGGCGCTATC -> TCCAGAAGGGGCGCTATCG
CTCCCCGTGTCATGTGTGG -> TCCCCGTGTCATGTGTGGT
CTCCCGGAAGGATAAATGG -> TCCCGGAAGGATAAATGGT
CTCCGAGATCGATGCGACA -> TCCGAGATCGATGCGACAG
CTCCGTAGACGCTTTAACA -> TCCGTAGACGCTTTAACAT
CTCCTAATTGGACTTTAAA -> TCCTAATTGGACTTTAAAT
CTCGACAGCCCACTCCAGA -> TCGACAGCCCACTCCAGAA
CTCGCAAACGACCTTTGCG -> TCGCAAACGACCTTTGCGT
CTCGCAGAGAACTCTTCTT -> TCGCAGAGAACTCTTCTTT
CTCGCTTAACCCTATTTAG -> TCGCTTAACCCTATTTAGG
CTCGTGAAAGCCCTTTCAA -> TCGTGAAAGCCCTTTCAAA
CTCTACTGGTAATGTACGC -> TCTACTGGTAATGTACGCA
CTCTCGACAGCCCACTCCA -> TCTCGACAGCCCACTCCAG
CTCTCGCTTAACCCTATTT -> TCTCGCTTAACCCTATTTA
CTCTTATCGAGTTGACGGC -> TCTTATCGAGTTGACGGCC
CTCTTCTTTCGGATTCACG -> TCTTCTTTCGGATTCACGC
CTCTTGACTATCCGCATCG -> TCTTGACTATCCGCATCGT
CTGAAATAGTACTTGTAAG -> TGAAATAGTACTTGTAAGC
CTGACAAAGTGCGGATTGT -> TGACAAAGTGCGGATTGTC
CTGACATTGAGCAAGTCCA -> TGACATTGAGCAAGTCCAC
CTGAGAAAGTTGCAGTAGT -> TGAGAAAGTTGCAGTAGTT
CTGAGCCGCCCAGCTAAAG -> TGAGCCGCCCAGCTAAAGC
CTGAGGCCGTAAAGGTGTA -> TGAGGCCGTAAAGGTGTAT
CTGAGGCTTGTCTAGTCTG -> TGAGGCTTGTCTAGTCTGC
CTGCAAATATACTTTCTGG -> TGCAAATATACTTTCTGGT
CTGCAATGGAGCTTGTTGG -> TGCAATGGAGCTTGTTGGA
CTGCACCGGACACGAAGAC -> TGCACCGGACACGAAGACA
CTGCATTGGAATTTTGAAT -> TGCATTGGAATTTTGAATT
CTGCCATAAGTGATGCGGT -> TGCCATAAGTGATGCGGTT
CTGCCGATGCAGATCATAT -> TGCCGATGCAGATCATATT
CTGCCTCTTGACTATCCGC -> TGCCTCTTGACTATCCGCA
CTGCGCTTAGGGTATCAAC -> TGCGCTTAGGGTATCAACA
CTGCTTAAAGCCGTTCATA -> TGCTTAAAGCCGTTCATAC
CTGGAAGTCCAGCTTCAAG -> TGGAAGTCCAGCTTCAAGC
CTGGAATCATACCCAGCGC -> TGGAATCATACCCAGCGCT
CTGGCATCAAGACGGTCTT -> TGGCATCAAGACGGTCTTT
CTGGCCAAATAACCCGGAG -> TGGCCAAATAACCCGGAGT
CTGGCCTGGTAGACGCTTT -> TGGCCTGGTAGACGCTTTA
CTGGCTCCCGGAAGGATAA -> TGGCTCCCGGAAGGATAAA
CTGGGGTCCGCCGTATCAT -> TGGGGTCCGCCGTATCATG
CTGGGTTAGTGTGGATAAA -> TGGGTTAGTGTGGATAAAC
CTGGTAATGTACGCAGAAG -> TGGTAATGTACGCAGAAGA
CTGGTAGACGCTTTAACAT -> TGGTAGACGCTTTAACATA
CTGGTCAATCAACAGGACC -> TGGTCAATCAACAGGACCG
CTGGTGTAACCGCTGGCCA -> TGGTGTAACCGCTGGCCAA
CTGGTTGTCCGAATTACTG -> TGGTTGTCCGAATTACTGG
CTGTCTACATAGTCCCTAT -> TGTCTACATAGTCCCTATA
CTGTTCAGCAAGTTGCTGG -> TGTTCAGCAAGTTGCTGGC
CTGTTTATCTCGCAAACGA -> TGTTTATCTCGCAAACGAC
CTTAAAATTAGATAGTAGG -> TTAAAATTAGATAGTAGGC
CTTAAAGCCGTTCATACTC -> TTAAAGCCGTTCATACTCC
CTTAACCCTATTTAGGCTG -> TTAACCCTATTTAGGCTGC
CTTAACCTACAGTGCTGAG -> TTAACCTACAGTGCTGAGG
CTTAGGGTATCAACAGTAC -> TTAGGGTATCAACAGTACG
CTTATCGAGTTGACGGCCA -> TTATCGAGTTGACGGCCAA
CTTATGAGCAAGTCCACAT -> TTATGAGCAAGTCCACATT
CTTATTAATGCGAGTGTAT -> TTATTAATGCGAGTGTATA
CTTATTAGCAACCACAAAT -> TTATTAGCAACCACAAATA
CTTATTCAGGCTGAGGCCG -> TTATTCAGGCTGAGGCCGT
CTTATTGTAACACTTCTAT -> TTATTGTAACACTTCTATA
CTTCAAGCAAGCAGCTGGG -> TTCAAGCAAGCAGCTGGGT
CTTCCCGCCGTTAAACCAG -> TTCCCGCCGTTAAACCAGG
CTTCCTCTCGCTTAACCCT -> TTCCTCTCGCTTAACCCTA
CTTCTATAGACTATAGTTG -> TTCTATAGACTATAGTTGT
CTTCTCAGAGCTACCCAAT -> TTCTCAGAGCTACCCAATT
CTTCTCCGTAGACGCTTTA -> TTCTCCGTAGACGCTTTAA
CTTCTGCGCTTAGGGTATC -> TTCTGCGCTTAGGGTATCA
CTTCTGGTGTAACCGCTGG -> TTCTGGTGTAACCGCTGGC
CTTCTTTCGGATTCACGCG -> TTCTTTCGGATTCACGCGC
CTTGAAACAGAGGGGCGTG -> TTGAAACAGAGGGGCGTGC
CTTGAATAGTAGACGCTTT -> TTGAATAGTAGACGCTTTA
CTTGACTATCCGCATCGTA -> TTGACTATCCGCATCGTAA
CTTGGCCGATTATGTAATC -> TTGGCCGATTATGTAATCA
CTTGGGTGTCGAATCAAGA -> TTGGGTGTCGAATCAAGAT
CTTGTAAGCCCTCAATGCA -> TTGTAAGCCCTCAATGCAT
CTTGTCTAGTCTGCAAATA -> TTGTCTAGTCTGCAAATAT
CTTGTTGGAAAGGATGCGC -> TTGTTGGAAAGGATGCGCG
CTTGTTGGGGGTAAGACGA -> TTGTTGGGGGTAAGACGAG
CTTTAAATACTATAAGCTA -> TTTAAATACTATAAGCTAG
CTTTAACATAGAATATGTA -> TTTAACATAGAATATGTAA
CTTTAACATAGCATGTGCG -> TTTAACATAGCATGTGCGT
CTTTAACATAGGCATTTGT -> TTTAACATAGGCATTTGTA
CTTTAACATAGTTACCCCC -> TTTAACATAGTTACCCCCT
CTTTACTTGGGTGTCGAAT -> TTTACTTGGGTGTCGAATC
CTTTCAAATCACTCCCCGT -> TTTCAAATCACTCCCCGTG
CTTTCGGATTCACGCGCCC -> TTTCGGATTCACGCGCCCA
CTTTCTGGTTGTCCGAATT -> TTTCTGGTTGTCCGAATTA
CTTTGCGTTTGTTGCATAA -> TTTGCGTTTGTTGCATAAT
CTTTGGTCCACTAGTTAGC -> TTTGGTCCACTAGTTAGCT
GAAAACGTCCGTACTGGCC -> AAAACGTCCGTACTGGCCT
GAAACAGAGGGGCGTGCCC -> AAACAGAGGGGCGTGCCCG
GAAAGCAAAGGGTTAAAAG -> AAAGCAAAGGGTTAAAAGC
GAAAGCCCTTTCAAATCAC -> AAAGCCCTTTCAAATCACT
GAAAGCTTAACCTACAGTG -> AAAGCTTAACCTACAGTGC
GAAAGGATGCGCGTACTTG -> AAAGGATGCGCGTACTTGG
GAAAGGGCAGTAACAGTAA -> AAAGGGCAGTAACAGTAAA
GAAAGGTATAAGACATCAA -> AAAGGTATAAGACATCAAG
GAAAGTTGCAGTAGTTATT -> AAAGTTGCAGTAGTTATTC
GAAATAGTACTTGTAAGCC -> AAATAGTACTTGTAAGCCC
GAAATTATAATTACGGATC -> AAATTATAATTACGGATCC
GAAATTCCAAGTATTCAGA -> AAATTCCAAGTATTCAGAG
GAACACCGGTTCATTCATA -> AACACCGGTTCATTCATAA
GAACCCGAGCCCTCATACT -> AACCCGAGCCCTCATACTA
GAACTCTTCTTTCGGATTC -> AACTCTTCTTTCGGATTCA
GAAGACAATCAAGCAAATT -> AAGACAATCAAGCAAATTA
GAAGACGACATTGAATACC -> AAGACGACATTGAATACCG
GAAGCCGCACCTGAGAAAG -> AAGCCGCACCTGAGAAAGT
GAAGGATAAATGGTTAGCT -> AAGGATAAATGGTTAGCTG
GAAGGGGCGCTATCGGCAG -> AAGGGGCGCTATCGGCAGA
GAAGGTCATCCACTCTTAT -> AAGGTCATCCACTCTTATC
GAAGTCCAGCTTCAAGCAA -> AAGTCCAGCTTCAAGCAAG
GAAGTGAGAGTCCCCCGGT -> AAGTGAGAGTCCCCCGGTA
GAATAAGATTCCTGGAATC -> AATAAGATTCCTGGAATCA
GAATACCGCTTCTCCGTAG -> AATACCGCTTCTCCGTAGA
GAATACCTAATTCTTCTGC -> AATACCTAATTCTTCTGCG
GAATAGTAGACGCTTTAAC -> AATAGTAGACGCTTTAACA
GAATATGTAAATTGAGCAA -> AATATGTAAATTGAGCAAG
GAATCAAGATCTTGAAACA -> AATCAAGATCTTGAAACAG
GAATCATACCCAGCGCTTC -> AATCATACCCAGCGCTTCG
GAATGGTATGGTCTAGAGT -> AATGGTATGGTCTAGAGTA
GAATTACTGGCATCAAGAC -> AATTACTGGCATCAAGACG
GAATTCCTATAACGGGTGT -> AATTCCTATAACGGGTGTG
GAATTCGCTGTCTACATAG -> AATTCGCTGTCTACATAGT
GAATTTTGAATTCGCTGTC -> AATTTTGAATTCGCTGTCT
GACAAAGTGCGGATTGTCT -> ACAAAGTGCGGATTGTCTT
GACAACAGCGGTTCCAAGA -> ACAACAGCGGTTCCAAGAA
GACAATCAAGCAAATTAAT -> ACAATCAAGCAAATTAATA
GACACGAAGACAATCAAGC -> ACACGAAGACAATCAAGCA
GACACTTCCCGCCGTTAAA -> ACACTTCCCGCCGTTAAAC
GACAGCCCACTCCAGAAGG -> ACAGCCCACTCCAGAAGGG
GACAGGCGGAACCCGAGCC -> ACAGGCGGAACCCGAGCCC
GACATCAAGGAATAAGATT -> ACATCAAGGAATAAGATTC
GACATTCTCAGGCCAGAGC -> ACATTCTCAGGCCAGAGCC
GACATTGAATACCGCTTCT -> ACATTGAATACCGCTTCTC
GACATTGAGCAAGTCCACA -> ACATTGAGCAAGTCCACAT
GACATTGGGTAAAGCTGCC -> ACATTGGGTAAAGCTGCCT
GACCGGGTTCGTGGCAGTA -> ACCGGGTTCGTGGCAGTAG
GACCTACTTGAATAGTAGA -> ACCTACTTGAATAGTAGAC
GACCTGTTCAGCAAGTTGC -> ACCTGTTCAGCAAGTTGCT
GACCTTTGCGTTTGTTGCA -> ACCTTTGCGTTTGTTGCAT
GACGACATTGAATACCGCT -> ACGACATTGAATACCGCTT
GACGAGGCTCACGACATTG -> ACGAGGCTCACGACATTGG
GACGCACATACCGTCCAGA -> ACGCACATACCGTCCAGAT
GACGCTTTAACATAGAATA -> ACGCTTTAACATAGAATAT
GACGCTTTAACATAGCATG -> ACGCTTTAACATAGCATGT
GACGCTTTAACATAGGCAT -> ACGCTTTAACATAGGCATT
GACGCTTTAACATAGTTAC -> ACGCTTTAACATAGTTACC
GACGGCCAAGGATGCCGGC -> ACGGCCAAGGATGCCGGCG
GACGGTCTTTGGTCCACTA -> ACGGTCTTTGGTCCACTAG
GACGTCTTATTAATGCGAG -> ACGTCTTATTAATGCGAGT
GACTATAGTTGTGGTTGAA -> ACTATAGTTGTGGTTGAAA
GACTATCCGCATCGTAATG -> ACTATCCGCATCGTAATGA
GACTTTAAATACTATAAGC -> ACTTTAAATACTATAAGCT
GAGAAAGTTGCAGTAGTTA -> AGAAAGTTGCAGTAGTTAT
GAGAACTCTTCTTTCGGAT -> AGAACTCTTCTTTCGGATT
GAGACATTCTCAGGCCAGA -> AGACATTCTCAGGCCAGAG
GAGACGTCTTATTAATGCG -> AGACGTCTTATTAATGCGA
GAGAGCATGTAAACCGTCC -> AGAGCATGTAAACCGTCCC
GAGAGTCCCCCGGTACTTA -> AGAGTCCCCCGGTACTTAT
GAGATCGATGCGACAGGCG -> AGATCGATGCGACAGGCGG
GAGCAAGTCCACATTGCCC -> AGCAAGTCCACATTGCCCG
GAGCAAGTCCACATTGCCG -> AGCAAGTCCACATTGCCGC,AGCAAGTCCACATTGCCGT
GAGCAAGTCCACATTGCCT -> AGCAAGTCCACATTGCCTG
GAGCATGTAAACCGTCCCT -> AGCATGTAAACCGTCCCTT
GAGCCCTCATACTACGATG -> AGCCCTCATACTACGATGG
GAGCCGCCCAGCTAAAGCG -> AGCCGCCCAGCTAAAGCGG
GAGCCTGGGGTCCGCCGTA -> AGCCTGGGGTCCGCCGTAT
GAGCTACCCAATTGCATCG -> AGCTACCCAATTGCATCGG
GAGCTTGTTGGAAAGGATG -> AGCTTGTTGGAAAGGATGC
GAGGCCGTAAAGGTGTATT -> AGGCCGTAAAGGTGTATTC
GAGGCGTGGCATGAACACC -> AGGCGTGGCATGAACACCG
GAGGCTCACGACATTGGGT -> AGGCTCACGACATTGGGTA
GAGGCTTGTCTAGTCTGCA -> AGGCTTGTCTAGTCTGCAA
GAGGGGCGTGCCCGAGGCG -> AGGGGCGTGCCCGAGGCGT
GAGGTACTGCTTAAAGCCG -> AGGTACTGCTTAAAGCCGT
GAGTAGCAGTACCAGTAGA -> AGTAGCAGTACCAGTAGAC
GAGTAGTGGCGTGAATGGT -> AGTAGTGGCGTGAATGGTA
GAGTATCGCTGAAATAGTA -> AGTATCGCTGAAATAGTAC
GAGTCCCCCGGTACTTATT -> AGTCCCCCGGTACTTATTC
GAGTGTATAGTTGTCAAAT -> AGTGTATAGTTGTCAAATG
GAGTTGACGGCCAAGGATG -> AGTTGACGGCCAAGGATGC
GATAAACCGGAGACGTCTT -> ATAAACCGGAGACGTCTTA
GATAAATGGTTAGCTGCAC -> ATAAATGGTTAGCTGCACC
GATAGGTATCGGGTAAGAA -> ATAGGTATCGGGTAAGAAA
GATAGTAGGCTGTTTATCT -> ATAGTAGGCTGTTTATCTC
GATCATATTCCGGGATGTC -> ATCATATTCCGGGATGTCC
GATCCGCTTGTTGGGGGTA -> ATCCGCTTGTTGGGGGTAA
GATCCGGGAAGCCGCACCT -> ATCCGGGAAGCCGCACCTG
GATCGATGCGACAGGCGGA -> ATCGATGCGACAGGCGGAA
GATCGCAAGGGTATGGAAA -> ATCGCAAGGGTATGGAAAG
GATCGTGATCGCAAGGGTA -> ATCGTGATCGCAAGGGTAT
GATCTTGAAACAGAGGGGC -> ATCTTGAAACAGAGGGGCG
GATGCAGATCATATTCCGG -> ATGCAGATCATATTCCGGG
GATGCCGGCGGTCAGACCT -> ATGCCGGCGGTCAGACCTA
GATGCGACAGGCGGAACCC -> ATGCGACAGGCGGAACCCG
GATGCGCGTACTTGGCCGA -> ATGCGCGTACTTGGCCGAT
GATGCGGTTGGACGCACAT -> ATGCGGTTGGACGCACATA
GATGCTCCGAGATCGATGC -> ATGCTCCGAGATCGATGCG
GATGGTCGGCGGCTGAGCC -> ATGGTCGGCGGCTGAGCCG
GATGGTTAACCTTAAAATT -> ATGGTTAACCTTAAAATTA
GATGTCCTATCTTCCTCTC -> ATGTCCTATCTTCCTCTCG
GATTAGGAAGTGAGAGTCC -> ATTAGGAAGTGAGAGTCCC
GATTATGTAATCAAGTTCA -> ATTATGTAATCAAGTTCAC
GATTCACGCGCCCATCTCT -> ATTCACGCGCCCATCTCTC
GATTCCTGGAATCATACCC -> ATTCCTGGAATCATACCCA
GATTGTCTTTACTTGGGTG -> ATTGTCTTTACTTGGGTGT
GATTTTCATGTAAGGTGCT -> ATTTTCATGTAAGGTGCTA
GCAAACGACCTTTGCGTTT -> CAAACGACCTTTGCGTTTG
GCAAAGGGTTAAAAGCGCG -> CAAAGGGTTAAAAGCGCGG
GCAAAGTTGGCAATCACAC -> CAAAGTTGGCAATCACACT
GCAAATATACTTTCTGGTT -> CAAATATACTTTCTGGTTG
GCAAATGGCCTGGAAGTCC -> CAAATGGCCTGGAAGTCCA
GCAAATTAATAACCCTCGC -> CAAATTAATAACCCTCGCA
GCAACCACAAATAAAGTAC -> CAACCACAAATAAAGTACC
GCAAGCAGCTGGGTTAGTG -> CAAGCAGCTGGGTTAGTGT
GCAAGGGTATGGAAAGGGC -> CAAGGGTATGGAAAGGGCA
GCAAGTCCACATTGCCCGC -> CAAGTCCACATTGCCCGCT
GCAAGTCCACATTGCCGCA -> CAAGTCCACATTGCCGCAG
GCAAGTCCACATTGCCGTG -> CAAGTCCACATTGCCGTGC
GCAAGTCCACATTGCCTGA -> CAAGTCCACATTGCCTGAC
GCAAGTTGCTGGCTCCCGG -> CAAGTTGCTGGCTCCCGGA
GCAATCACACTGCCATAAG -> CAATCACACTGCCATAAGT
GCAATGGAGCTTGTTGGAA -> CAATGGAGCTTGTTGGAAA
GCACATACCGTCCAGATTT -> CACATACCGTCCAGATTTT
GCACCGGACACGAAGACAA -> CACCGGACACGAAGACAAT
GCACCTGAGAAAGTTGCAG -> CACCTGAGAAAGTTGCAGT
GCAGAAGACGACATTGAAT -> CAGAAGACGACATTGAATA
GCAGAGAACTCTTCTTTCG -> CAGAGAACTCTTCTTTCGG
GCAGATCATATTCCGGGAT -> CAGATCATATTCCGGGATG
GCAGATCGTGATCGCAAGG -> CAGATCGTGATCGCAAGGG
GCAGCTGGGTTAGTGTGGA -> CAGCTGGGTTAGTGTGGAT
GCAGGGCAGTTACTAACTT -> CAGGGCAGTTACTAACTTA
GCAGTAACAGTAAAACTGG -> CAGTAACAGTAAAACTGGT
GCAGTACCAGTAGACACTT -> CAGTACCAGTAGACACTTC
GCAGTAGGAATTCCTATAA -> CAGTAGGAATTCCTATAAC
GCAGTAGTTATTCCTGCAT -> CAGTAGTTATTCCTGCATT
GCAGTCACTACGGTGGTGC -> CAGTCACTACGGTGGTGCA
GCAGTCGAAAGCAAAGGGT -> CAGTCGAAAGCAAAGGGTT
GCAGTTACTAACTTATTAG -> CAGTTACTAACTTATTAGC
GCATAATGCAAATGGCCTG -> CATAATGCAAATGGCCTGG
GCATATCCAAATAATGTTG -> CATATCCAAATAATGTTGG
GCATCAAGACGGTCTTTGG -> CATCAAGACGGTCTTTGGT
GCATCGGCAGTCACTACGG -> CATCGGCAGTCACTACGGT
GCATCGTAATGAAGGTCAT -> CATCGTAATGAAGGTCATC
GCATGAACACCGGTTCATT -> CATGAACACCGGTTCATTC
GCATGGCGGATGCTCCGAG -> CATGGCGGATGCTCCGAGA
GCATGTAAACCGTCCCTTA -> CATGTAAACCGTCCCTTAT
GCATGTGCGTTTTGAGCAA -> CATGTGCGTTTTGAGCAAG
GCATGTGTTTCCACCCGAA -> CATGTGTTTCCACCCGAAT
GCATTACATTCGTCCAGTG -> CATTACATTCGTCCAGTGC
GCATTGGAATTTTGAATTC -> CATTGGAATTTTGAATTCG
GCATTGGCGGCGGATTAGG -> CATTGGCGGCGGATTAGGA
GCATTTGTAGACGCTTTAA -> CATTTGTAGACGCTTTAAC
GCCAAATAACCCGGAGTAG -> CCAAATAACCCGGAGTAGC
GCCAAGGATGCCGGCGGTC -> CCAAGGATGCCGGCGGTCA
GCCAGAGCCTGGGGTCCGC -> CCAGAGCCTGGGGTCCGCC
GCCATAAGTGATGCGGTTG -> CCATAAGTGATGCGGTTGG
GCCCACTCCAGAAGGGGCG -> CCCACTCCAGAAGGGGCGC
GCCCAGCTAAAGCGGCCCT -> CCCAGCTAAAGCGGCCCTC
GCCCATCTCTCGACAGCCC -> CCCATCTCTCGACAGCCCA
GCCCGAGGCGTGGCATGAA -> CCCGAGGCGTGGCATGAAC
GCCCGCTCGTGAAAGCCCT -> CCCGCTCGTGAAAGCCCTT
GCCCTCAATGCATTGGCGG -> CCCTCAATGCATTGGCGGC
GCCCTCATACTACGATGGT -> CCCTCATACTACGATGGTC
GCCCTCTACTGGTAATGTA -> CCCTCTACTGGTAATGTAC
GCCCTTCTCAGAGCTACCC -> CCCTTCTCAGAGCTACCCA
GCCCTTTCAAATCACTCCC -> CCCTTTCAAATCACTCCCC
GCCGATGCAGATCATATTC -> CCGATGCAGATCATATTCC
GCCGATTATGTAATCAAGT -> CCGATTATGTAATCAAGTT
GCCGCACCTGAGAAAGTTG -> CCGCACCTGAGAAAGTTGC
GCCGCAGTCGAAAGCAAAG -> CCGCAGTCGAAAGCAAAGG
GCCGCCCAGCTAAAGCGGC -> CCGCCCAGCTAAAGCGGCC
GCCGGCGGTCAGACCTACT -> CCGGCGGTCAGACCTACTT
GCCGTAAAGGTGTATTCAT -> CCGTAAAGGTGTATTCATA
GCCGTATCATGGAGTAGTG -> CCGTATCATGGAGTAGTGG
GCCGTGCAGGGCAGTTACT -> CCGTGCAGGGCAGTTACTA
GCCGTTAAACCAGGTCACA -> CCGTTAAACCAGGTCACAC
GCCGTTCATACTCCTAATT -> CCGTTCATACTCCTAATTG
GCCTAATATCGATCCGGGA -> CCTAATATCGATCCGGGAA
GCCTCTTGACTATCCGCAT -> CCTCTTGACTATCCGCATC
GCCTGACATTGAGCAAGTC -> CCTGACATTGAGCAAGTCC
GCCTGGAAGTCCAGCTTCA -> CCTGGAAGTCCAGCTTCAA
GCCTGGGGTCCGCCGTATC -> CCTGGGGTCCGCCGTATCA
GCCTGGTAGACGCTTTAAC -> CCTGGTAGACGCTTTAACA
GCGAAAACGTCCGTACTGG -> CGAAAACGTCCGTACTGGC
GCGACAGGCGGAACCCGAG -> CGACAGGCGGAACCCGAGC
GCGAGTGTATAGTTGTCAA -> CGAGTGTATAGTTGTCAAA
GCGATAGGTATCGGGTAAG -> CGATAGGTATCGGGTAAGA
GCGCCCATCTCTCGACAGC -> CGCCCATCTCTCGACAGCC
GCGCGGAGGTACTGCTTAA -> CGCGGAGGTACTGCTTAAA
GCGCGTACTTGGCCGATTA -> CGCGTACTTGGCCGATTAT
GCGCTATCGGCAGATCGTG -> CGCTATCGGCAGATCGTGA
GCGCTTAGGGTATCAACAG -> CGCTTAGGGTATCAACAGT
GCGGAACCCGAGCCCTCAT -> CGGAACCCGAGCCCTCATA
GCGGAGGTACTGCTTAAAG -> CGGAGGTACTGCTTAAAGC
GCGGATGCTCCGAGATCGA -> CGGATGCTCCGAGATCGAT
GCGGATTAGGAAGTGAGAG -> CGGATTAGGAAGTGAGAGT
GCGGATTGTCTTTACTTGG -> CGGATTGTCTTTACTTGGG
GCGGCCCTCTACTGGTAAT -> CGGCCCTCTACTGGTAATG
GCGGCGGATTAGGAAGTGA -> CGGCGGATTAGGAAGTGAG
GCGGCTGAGCCGCCCAGCT -> CGGCTGAGCCGCCCAGCTA
GCGGTCAGACCTACTTGAA -> CGGTCAGACCTACTTGAAT
GCGGTTCCAAGAAAGGTAT -> CGGTTCCAAGAAAGGTATA
GCGGTTGGACGCACATACC -> CGGTTGGACGCACATACCG
GCGTACTTGGCCGATTATG -> CGTACTTGGCCGATTATGT
GCGTATTCAAGGATGGTTA -> CGTATTCAAGGATGGTTAA
GCGTGAATGGTATGGTCTA -> CGTGAATGGTATGGTCTAG
GCGTGCCCGAGGCGTGGCA -> CGTGCCCGAGGCGTGGCAT
GCGTGGCATGAACACCGGT -> CGTGGCATGAACACCGGTT
GCGTTTGTTGCATAATGCA -> CGTTTGTTGCATAATGCAA
GCGTTTTGAGCAAGTCCAC -> CGTTTTGAGCAAGTCCACA
GCTAAAGCGGCCCTCTACT -> CTAAAGCGGCCCTCTACTG
GCTACCCAATTGCATCGGC -> CTACCCAATTGCATCGGCA
GCTAGTCAGACCTGTTCAG -> CTAGTCAGACCTGTTCAGC
GCTATCAGAGAGCATGTAA -> CTATCAGAGAGCATGTAAA
GCTATCCCGTGCATGGCGG -> CTATCCCGTGCATGGCGGA
GCTATCGGCAGATCGTGAT -> CTATCGGCAGATCGTGATC
GCTCACGACATTGGGTAAA -> CTCACGACATTGGGTAAAG
GCTCCCGGAAGGATAAATG -> CTCCCGGAAGGATAAATGG
GCTCCGAGATCGATGCGAC -> CTCCGAGATCGATGCGACA
GCTCGTGAAAGCCCTTTCA -> CTCGTGAAAGCCCTTTCAA
GCTGAAATAGTACTTGTAA -> CTGAAATAGTACTTGTAAG
GCTGAGCCGCCCAGCTAAA -> CTGAGCCGCCCAGCTAAAG
GCTGAGGCCGTAAAGGTGT -> CTGAGGCCGTAAAGGTGTA
GCTGAGGCTTGTCTAGTCT -> CTGAGGCTTGTCTAGTCTG
GCTGCAATGGAGCTTGTTG -> CTGCAATGGAGCTTGTTGG
GCTGCACCGGACACGAAGA -> CTGCACCGGACACGAAGAC
GCTGCCGATGCAGATCATA -> CTGCCGATGCAGATCATAT
GCTGCCTCTTGACTATCCG -> CTGCCTCTTGACTATCCGC
GCTGGCCAAATAACCCGGA -> CTGGCCAAATAACCCGGAG
GCTGGCTCCCGGAAGGATA -> CTGGCTCCCGGAAGGATAA
GCTGGGTTAGTGTGGATAA -> CTGGGTTAGTGTGGATAAA
GCTGTCTACATAGTCCCTA -> CTGTCTACATAGTCCCTAT
GCTGTTTATCTCGCAAACG -> CTGTTTATCTCGCAAACGA
GCTTAAAGCCGTTCATACT -> CTTAAAGCCGTTCATACTC
GCTTAACCCTATTTAGGCT -> CTTAACCCTATTTAGGCTG
GCTTAACCTACAGTGCTGA -> CTTAACCTACAGTGCTGAG
GCTTAGGGTATCAACAGTA -> CTTAGGGTATCAACAGTAC
GCTTCAAGCAAGCAGCTGG -> CTTCAAGCAAGCAGCTGGG
GCTTCTCCGTAGACGCTTT -> CTTCTCCGTAGACGCTTTA
GCTTGTCTAGTCTGCAAAT -> CTTGTCTAGTCTGCAAATA
GCTTGTTGGAAAGGATGCG -> CTTGTTGGAAAGGATGCGC
GCTTGTTGGGGGTAAGACG -> CTTGTTGGGGGTAAGACGA
GCTTTAACATAGAATATGT -> CTTTAACATAGAATATGTA
GCTTTAACATAGCATGTGC -> CTTTAACATAGCATGTGCG
GCTTTAACATAGGCATTTG -> CTTTAACATAGGCATTTGT
GCTTTAACATAGTTACCCC -> CTTTAACATAGTTACCCCC
GGAAAGGATGCGCGTACTT -> GAAAGGATGCGCGTACTTG
GGAAAGGGCAGTAACAGTA -> GAAAGGGCAGTAACAGTAA
GGAACCCGAGCCCTCATAC -> GAACCCGAGCCCTCATACT
GGAAGCCGCACCTGAGAAA -> GAAGCCGCACCTGAGAAAG
GGAAGGATAAATGGTTAGC -> GAAGGATAAATGGTTAGCT
GGAAGTCCAGCTTCAAGCA -> GAAGTCCAGCTTCAAGCAA
GGAAGTGAGAGTCCCCCGG -> GAAGTGAGAGTCCCCCGGT
GGAATAAGATTCCTGGAAT -> GAATAAGATTCCTGGAATC
GGAATCATACCCAGCGCTT -> GAATCATACCCAGCGCTTC
GGAATTCCTATAACGGGTG -> GAATTCCTATAACGGGTGT
GGAATTTTGAATTCGCTGT -> GAATTTTGAATTCGCTGTC
GGACAACAGCGGTTCCAAG -> GACAACAGCGGTTCCAAGA
GGACACGAAGACAATCAAG -> GACACGAAGACAATCAAGC
GGACCGGGTTCGTGGCAGT -> GACCGGGTTCGTGGCAGTA
GGACGCACATACCGTCCAG -> GACGCACATACCGTCCAGA
GGACTTTAAATACTATAAG -> GACTTTAAATACTATAAGC
GGAGACGTCTTATTAATGC -> GAGACGTCTTATTAATGCG
GGAGCTTGTTGGAAAGGAT -> GAGCTTGTTGGAAAGGATG
GGAGGTACTGCTTAAAGCC -> GAGGTACTGCTTAAAGCCG
GGAGTAGCAGTACCAGTAG -> GAGTAGCAGTACCAGTAGA
GGAGTAGTGGCGTGAATGG -> GAGTAGTGGCGTGAATGGT
GGATAAACCGGAGACGTCT -> GATAAACCGGAGACGTCTT
GGATAAATGGTTAGCTGCA -> GATAAATGGTTAGCTGCAC
GGATCCGCTTGTTGGGGGT -> GATCCGCTTGTTGGGGGTA
GGATGCCGGCGGTCAGACC -> GATGCCGGCGGTCAGACCT
GGATGCGCGTACTTGGCCG -> GATGCGCGTACTTGGCCGA
GGATGCTCCGAGATCGATG -> GATGCTCCGAGATCGATGC
GGATGGTTAACCTTAAAAT -> GATGGTTAACCTTAAAATT
GGATGTCCTATCTTCCTCT -> GATGTCCTATCTTCCTCTC
GGATTAGGAAGTGAGAGTC -> GATTAGGAAGTGAGAGTCC
GGATTCACGCGCCCATCTC -> GATTCACGCGCCCATCTCT
GGATTGTCTTTACTTGGGT -> GATTGTCTTTACTTGGGTG
GGCAAAGTTGGCAATCACA -> GCAAAGTTGGCAATCACAC
GGCAATCACACTGCCATAA -> GCAATCACACTGCCATAAG
GGCAGATCGTGATCGCAAG -> GCAGATCGTGATCGCAAGG
GGCAGTAACAGTAAAACTG -> GCAGTAACAGTAAAACTGG
GGCAGTAGGAATTCCTATA -> GCAGTAGGAATTCCTATAA
GGCAGTCACTACGGTGGTG -> GCAGTCACTACGGTGGTGC
GGCAGTTACTAACTTATTA -> GCAGTTACTAACTTATTAG
GGCATCAAGACGGTCTTTG -> GCATCAAGACGGTCTTTGG
GGCATGAACACCGGTTCAT -> GCATGAACACCGGTTCATT
GGCATGTGTTTCCACCCGA -> GCATGTGTTTCCACCCGAA
GGCATTACATTCGTCCAGT -> GCATTACATTCGTCCAGTG
GGCATTTGTAGACGCTTTA -> GCATTTGTAGACGCTTTAA
GGCCAAATAACCCGGAGTA -> GCCAAATAACCCGGAGTAG
GGCCAAGGATGCCGGCGGT -> GCCAAGGATGCCGGCGGTC
GGCCAGAGCCTGGGGTCCG -> GCCAGAGCCTGGGGTCCGC
GGCCCTCTACTGGTAATGT -> GCCCTCTACTGGTAATGTA
GGCCGATTATGTAATCAAG -> GCCGATTATGTAATCAAGT
GGCCGTAAAGGTGTATTCA -> GCCGTAAAGGTGTATTCAT
GGCCTGGAAGTCCAGCTTC -> GCCTGGAAGTCCAGCTTCA
GGCCTGGTAGACGCTTTAA -> GCCTGGTAGACGCTTTAAC
GGCGAAAACGTCCGTACTG -> GCGAAAACGTCCGTACTGG
GGCGCTATCGGCAGATCGT -> GCGCTATCGGCAGATCGTG
GGCGGAACCCGAGCCCTCA -> GCGGAACCCGAGCCCTCAT
GGCGGATGCTCCGAGATCG -> GCGGATGCTCCGAGATCGA
GGCGGATTAGGAAGTGAGA -> GCGGATTAGGAAGTGAGAG
GGCGGCGGATTAGGAAGTG -> GCGGCGGATTAGGAAGTGA
GGCGGCTGAGCCGCCCAGC -> GCGGCTGAGCCGCCCAGCT
GGCGGTCAGACCTACTTGA -> GCGGTCAGACCTACTTGAA
GGCGTATTCAAGGATGGTT -> GCGTATTCAAGGATGGTTA
GGCGTGAATGGTATGGTCT -> GCGTGAATGGTATGGTCTA
GGCGTGCCCGAGGCGTGGC -> GCGTGCCCGAGGCGTGGCA
GGCGTGGCATGAACACCGG -> GCGTGGCATGAACACCGGT
GGCTCACGACATTGGGTAA -> GCTCACGACATTGGGTAAA
GGCTCCCGGAAGGATAAAT -> GCTCCCGGAAGGATAAATG
GGCTGAGCCGCCCAGCTAA -> GCTGAGCCGCCCAGCTAAA
GGCTGAGGCCGTAAAGGTG -> GCTGAGGCCGTAAAGGTGT
GGCTGCAATGGAGCTTGTT -> GCTGCAATGGAGCTTGTTG
GGCTGTTTATCTCGCAAAC -> GCTGTTTATCTCGCAAACG
GGCTTGTCTAGTCTGCAAA -> GCTTGTCTAGTCTGCAAAT
GGGAAGCCGCACCTGAGAA -> GGAAGCCGCACCTGAGAAA
GGGATGTCCTATCTTCCTC -> GGATGTCCTATCTTCCTCT
GGGCAAAGTTGGCAATCAC -> GGCAAAGTTGGCAATCACA
GGGCAGTAACAGTAAAACT -> GGCAGTAACAGTAAAACTG
GGGCAGTTACTAACTTATT -> GGCAGTTACTAACTTATTA
GGGCGCTATCGGCAGATCG -> GGCGCTATCGGCAGATCGT
GGGCGTGCCCGAGGCGTGG -> GGCGTGCCCGAGGCGTGGC
GGGGCGCTATCGGCAGATC -> GGGCGCTATCGGCAGATCG
GGGGCGTGCCCGAGGCGTG -> GGGCGTGCCCGAGGCGTGG
GGGGGTAAGACGAGGCTCA -> GGGGTAAGACGAGGCTCAC
GGGGTAAGACGAGGCTCAC -> GGGTAAGACGAGGCTCACG
GGGGTCCGCCGTATCATGG -> GGGTCCGCCGTATCATGGA
GGGTAAAGCTGCCTCTTGA -> GGTAAAGCTGCCTCTTGAC
GGGTAAGAAATTATAATTA -> GGTAAGAAATTATAATTAC
GGGTAAGACGAGGCTCACG -> GGTAAGACGAGGCTCACGA
GGGTATCAACAGTACGCGA -> GGTATCAACAGTACGCGAT
GGGTATGGAAAGGGCAGTA -> GGTATGGAAAGGGCAGTAA
GGGTCCGCCGTATCATGGA -> GGTCCGCCGTATCATGGAG
GGGTGTCGAATCAAGATCT -> GGTGTCGAATCAAGATCTT
GGGTGTGTCCCCAAAACGC -> GGTGTGTCCCCAAAACGCT
GGGTTAAAAGCGCGGAGGT -> GGTTAAAAGCGCGGAGGTA
GGGTTAGTGTGGATAAACC -> GGTTAGTGTGGATAAACCG
GGGTTCGTGGCAGTAGGAA -> GGTTCGTGGCAGTAGGAAT
GGTAAAGCTGCCTCTTGAC -> GTAAAGCTGCCTCTTGACT
GGTAAGAAATTATAATTAC -> GTAAGAAATTATAATTACG
GGTAAGACGAGGCTCACGA -> GTAAGACGAGGCTCACGAC
GGTAATGTACGCAGAAGAC -> GTAATGTACGCAGAAGACG
GGTACTGCTTAAAGCCGTT -> GTACTGCTTAAAGCCGTTC
GGTACTTATTCAGGCTGAG -> GTACTTATTCAGGCTGAGG
GGTAGACGCTTTAACATAG -> GTAGACGCTTTAACATAGG
GGTATAAGACATCAAGGAA -> GTATAAGACATCAAGGAAT
GGTATCAACAGTACGCGAT -> GTATCAACAGTACGCGATA
GGTATCGGGTAAGAAATTA -> GTATCGGGTAAGAAATTAT
GGTATGGAAAGGGCAGTAA -> GTATGGAAAGGGCAGTAAC
GGTATGGTCTAGAGTATCG -> GTATGGTCTAGAGTATCGC
GGTCAATCAACAGGACCGG -> GTCAATCAACAGGACCGGG
GGTCACACGGGCAAAGTTG -> GTCACACGGGCAAAGTTGG
GGTCAGACCTACTTGAATA -> GTCAGACCTACTTGAATAG
GGTCATCCACTCTTATCGA -> GTCATCCACTCTTATCGAG
GGTCCACTAGTTAGCTATC -> GTCCACTAGTTAGCTATCC
GGTCCGCCGTATCATGGAG -> GTCCGCCGTATCATGGAGT
GGTCGGCATTACATTCGTC -> GTCGGCATTACATTCGTCC
GGTCGGCGGCTGAGCCGCC -> GTCGGCGGCTGAGCCGCCC
GGTCTAGAGTATCGCTGAA -> GTCTAGAGTATCGCTGAAA
GGTCTTTGGTCCACTAGTT -> GTCTTTGGTCCACTAGTTA
GGTGCATATCCAAATAATG -> GTGCATATCCAAATAATGT
GGTGCTATCAGAGAGCATG -> GTGCTATCAGAGAGCATGT
GGTGGTGCATATCCAAATA -> GTGGTGCATATCCAAATAA
GGTGTAACCGCTGGCCAAA -> GTGTAACCGCTGGCCAAAT
GGTGTATTCATATAGGCGA -> GTGTATTCATATAGGCGAA
GGTGTCGAATCAAGATCTT -> GTGTCGAATCAAGATCTTG
GGTGTGTCCCCAAAACGCT -> GTGTGTCCCCAAAACGCTG
GGTTAAAAGCGCGGAGGTA -> GTTAAAAGCGCGGAGGTAC
GGTTAACCTTAAAATTAGA -> GTTAACCTTAAAATTAGAT
GGTTAGCTGCACCGGACAC -> GTTAGCTGCACCGGACACG
GGTTAGTGTGGATAAACCG -> GTTAGTGTGGATAAACCGG
GGTTCATTCATAAACTTCT -> GTTCATTCATAAACTTCTG
GGTTCCAAGAAAGGTATAA -> GTTCCAAGAAAGGTATAAG
GGTTCGTGGCAGTAGGAAT -> GTTCGTGGCAGTAGGAATT
GGTTGAAATTCCAAGTATT -> GTTGAAATTCCAAGTATTC
GGTTGGACGCACATACCGT -> GTTGGACGCACATACCGTC
GGTTGTCCGAATTACTGGC -> GTTGTCCGAATTACTGGCA
GTAAAACTGGTCAATCAAC -> TAAAACTGGTCAATCAACA
GTAAACCGTCCCTTATTGT -> TAAACCGTCCCTTATTGTA
GTAAAGCTGCCTCTTGACT -> TAAAGCTGCCTCTTGACTA
GTAAAGGTGTATTCATATA -> TAAAGGTGTATTCATATAG
GTAAATTGAGCAAGTCCAC -> TAAATTGAGCAAGTCCACA
GTAACACTTCTATAGACTA -> TAACACTTCTATAGACTAT
GTAACAGTAAAACTGGTCA -> TAACAGTAAAACTGGTCAA
GTAACCGCTGGCCAAATAA -> TAACCGCTGGCCAAATAAC
GTAAGAAATTATAATTACG -> TAAGAAATTATAATTACGG
GTAAGACGAGGCTCACGAC -> TAAGACGAGGCTCACGACA
GTAAGCCCTCAATGCATTG -> TAAGCCCTCAATGCATTGG
GTAAGGTGCTATCAGAGAG -> TAAGGTGCTATCAGAGAGC
GTAATCAAGTTCACTGACA -> TAATCAAGTTCACTGACAA
GTAATGAAGGTCATCCACT -> TAATGAAGGTCATCCACTC
GTAATGTACGCAGAAGACG -> TAATGTACGCAGAAGACGA
GTACCAGTAGACACTTCCC -> TACCAGTAGACACTTCCCG
GTACCCCCTAAGAAAGCTT -> TACCCCCTAAGAAAGCTTA
GTACGCAGAAGACGACATT -> TACGCAGAAGACGACATTG
GTACGCGATAGGTATCGGG -> TACGCGATAGGTATCGGGT
GTACTGCTTAAAGCCGTTC -> TACTGCTTAAAGCCGTTCA
GTACTGGCCTGGTAGACGC -> TACTGGCCTGGTAGACGCT
GTACTTATTCAGGCTGAGG -> TACTTATTCAGGCTGAGGC
GTACTTGGCCGATTATGTA -> TACTTGGCCGATTATGTAA
GTACTTGTAAGCCCTCAAT -> TACTTGTAAGCCCTCAATG
GTAGACACTTCCCGCCGTT -> TAGACACTTCCCGCCGTTA
GTAGACGCTTTAACATAGA -> TAGACGCTTTAACATAGAA
GTAGACGCTTTAACATAGC -> TAGACGCTTTAACATAGCA
GTAGACGCTTTAACATAGG -> TAGACGCTTTAACATAGGC
GTAGACGCTTTAACATAGT -> TAGACGCTTTAACATAGTT
GTAGCAGTACCAGTAGACA -> TAGCAGTACCAGTAGACAC
GTAGGAATTCCTATAACGG -> TAGGAATTCCTATAACGGG
GTAGGCTGTTTATCTCGCA -> TAGGCTGTTTATCTCGCAA
GTAGTGGCGTGAATGGTAT -> TAGTGGCGTGAATGGTATG
GTAGTTATTCCTGCATTGG -> TAGTTATTCCTGCATTGGA
GTATAAGACATCAAGGAAT -> TATAAGACATCAAGGAATA
GTATAGTTGTCAAATGCCT -> TATAGTTGTCAAATGCCTA
GTATCAACAGTACGCGATA -> TATCAACAGTACGCGATAG
GTATCATGGAGTAGTGGCG -> TATCATGGAGTAGTGGCGT
GTATCGCTGAAATAGTACT -> TATCGCTGAAATAGTACTT
GTATCGGGTAAGAAATTAT -> TATCGGGTAAGAAATTATA
GTATGGAAAGGGCAGTAAC -> TATGGAAAGGGCAGTAACA
GTATGGTCTAGAGTATCGC -> TATGGTCTAGAGTATCGCT
GTATTCAAGGATGGTTAAC -> TATTCAAGGATGGTTAACC
GTATTCAGAGACATTCTCA -> TATTCAGAGACATTCTCAG
GTATTCATATAGGCGAAAA -> TATTCATATAGGCGAAAAC
GTCAAATGCCTAATATCGA -> TCAAATGCCTAATATCGAT
GTCAATCAACAGGACCGGG -> TCAATCAACAGGACCGGGT
GTCACACGGGCAAAGTTGG -> TCACACGGGCAAAGTTGGC
GTCACTACGGTGGTGCATA -> TCACTACGGTGGTGCATAT
GTCAGACCTACTTGAATAG -> TCAGACCTACTTGAATAGT
GTCAGACCTGTTCAGCAAG -> TCAGACCTGTTCAGCAAGT
GTCATCCACTCTTATCGAG -> TCATCCACTCTTATCGAGT
GTCATGTGTGGTCGGCATT -> TCATGTGTGGTCGGCATTA
GTCCACATTGCCCGCTCGT -> TCCACATTGCCCGCTCGTG
GTCCACATTGCCGCAGTCG -> TCCACATTGCCGCAGTCGA
GTCCACATTGCCGTGCAGG -> TCCACATTGCCGTGCAGGG
GTCCACATTGCCTGACATT -> TCCACATTGCCTGACATTG
GTCCACTAGTTAGCTATCC -> TCCACTAGTTAGCTATCCC
GTCCAGATTTTCATGTAAG -> TCCAGATTTTCATGTAAGG
GTCCAGCTTCAAGCAAGCA -> TCCAGCTTCAAGCAAGCAG
GTCCAGTGCCCTTCTCAGA -> TCCAGTGCCCTTCTCAGAG
GTCCCCAAAACGCTGCCGA -> TCCCCAAAACGCTGCCGAT
GTCCCCCGGTACTTATTCA -> TCCCCCGGTACTTATTCAG
GTCCCTATAATTTGGCATG -> TCCCTATAATTTGGCATGT
GTCCCTTATTGTAACACTT -> TCCCTTATTGTAACACTTC
GTCCGAATTACTGGCATCA -> TCCGAATTACTGGCATCAA
GTCCGCCGTATCATGGAGT -> TCCGCCGTATCATGGAGTA
GTCCGTACTGGCCTGGTAG -> TCCGTACTGGCCTGGTAGA
GTCCTATCTTCCTCTCGCT -> TCCTATCTTCCTCTCGCTT
GTCGAAAGCAAAGGGTTAA -> TCGAAAGCAAAGGGTTAAA
GTCGAATCAAGATCTTGAA -> TCGAATCAAGATCTTGAAA
GTCGGCATTACATTCGTCC -> TCGGCATTACATTCGTCCA
GTCGGCGGCTGAGCCGCCC -> TCGGCGGCTGAGCCGCCCA
GTCTACATAGTCCCTATAA -> TCTACATAGTCCCTATAAT
GTCTAGAGTATCGCTGAAA -> TCTAGAGTATCGCTGAAAT
GTCTAGTCTGCAAATATAC -> TCTAGTCTGCAAATATACT
GTCTGCAAATATACTTTCT -> TCTGCAAATATACTTTCTG
GTCTTATTAATGCGAGTGT -> TCTTATTAATGCGAGTGTA
GTCTTTACTTGGGTGTCGA -> TCTTTACTTGGGTGTCGAA
GTCTTTGGTCCACTAGTTA -> TCTTTGGTCCACTAGTTAG
GTGAAAGCCCTTTCAAATC -> TGAAAGCCCTTTCAAATCA
GTGAATGGTATGGTCTAGA -> TGAATGGTATGGTCTAGAG
GTGAGAGTCCCCCGGTACT -> TGAGAGTCCCCCGGTACTT
GTGATCGCAAGGGTATGGA -> TGATCGCAAGGGTATGGAA
GTGATGCGGTTGGACGCAC -> TGATGCGGTTGGACGCACA
GTGCAGGGCAGTTACTAAC -> TGCAGGGCAGTTACTAACT
GTGCATATCCAAATAATGT -> TGCATATCCAAATAATGTT
GTGCATGGCGGATGCTCCG -> TGCATGGCGGATGCTCCGA
GTGCCCGAGGCGTGGCATG -> TGCCCGAGGCGTGGCATGA
GTGCCCTTCTCAGAGCTAC -> TGCCCTTCTCAGAGCTACC
GTGCGGATTGTCTTTACTT -> TGCGGATTGTCTTTACTTG
GTGCGTTTTGAGCAAGTCC -> TGCGTTTTGAGCAAGTCCA
GTGCTATCAGAGAGCATGT -> TGCTATCAGAGAGCATGTA
GTGCTGAGGCTTGTCTAGT -> TGCTGAGGCTTGTCTAGTC
GTGGATAAACCGGAGACGT -> TGGATAAACCGGAGACGTC
GTGGCAGTAGGAATTCCTA -> TGGCAGTAGGAATTCCTAT
GTGGCATGAACACCGGTTC -> TGGCATGAACACCGGTTCA
GTGGCGTGAATGGTATGGT -> TGGCGTGAATGGTATGGTC
GTGGTCGGCATTACATTCG -> TGGTCGGCATTACATTCGT
GTGGTGCATATCCAAATAA -> TGGTGCATATCCAAATAAT
GTGGTTGAAATTCCAAGTA -> TGGTTGAAATTCCAAGTAT
GTGTAACCGCTGGCCAAAT -> TGTAACCGCTGGCCAAATA
GTGTATAGTTGTCAAATGC -> TGTATAGTTGTCAAATGCC
GTGTATTCATATAGGCGAA -> TGTATTCATATAGGCGAAA
GTGTCATGTGTGGTCGGCA -> TGTCATGTGTGGTCGGCAT
GTGTCCCCAAAACGCTGCC -> TGTCCCCAAAACGCTGCCG
GTGTCGAATCAAGATCTTG -> TGTCGAATCAAGATCTTGA
GTGTGGATAAACCGGAGAC -> TGTGGATAAACCGGAGACG
GTGTGGTCGGCATTACATT -> TGTGGTCGGCATTACATTC
GTGTGTCCCCAAAACGCTG -> TGTGTCCCCAAAACGCTGC
GTGTTTCCACCCGAATACC -> TGTTTCCACCCGAATACCT
GTTAAAAGCGCGGAGGTAC -> TTAAAAGCGCGGAGGTACT
GTTAAACCAGGTCACACGG -> TTAAACCAGGTCACACGGG
GTTAACCTTAAAATTAGAT -> TTAACCTTAAAATTAGATA
GTTACCCCCTTATGAGCAA -> TTACCCCCTTATGAGCAAG
GTTACTAACTTATTAGCAA -> TTACTAACTTATTAGCAAC
GTTAGCTATCCCGTGCATG -> TTAGCTATCCCGTGCATGG
GTTAGCTGCACCGGACACG -> TTAGCTGCACCGGACACGA
GTTAGTGTGGATAAACCGG -> TTAGTGTGGATAAACCGGA
GTTATTCCTGCATTGGAAT -> TTATTCCTGCATTGGAATT
GTTCACTGACAAAGTGCGG -> TTCACTGACAAAGTGCGGA
GTTCAGCAAGTTGCTGGCT -> TTCAGCAAGTTGCTGGCTC
GTTCATACTCCTAATTGGA -> TTCATACTCCTAATTGGAC
GTTCATTCATAAACTTCTG -> TTCATTCATAAACTTCTGG
GTTCCAAGAAAGGTATAAG -> TTCCAAGAAAGGTATAAGA
GTTCGTGGCAGTAGGAATT -> TTCGTGGCAGTAGGAATTC
GTTGAAATTCCAAGTATTC -> TTGAAATTCCAAGTATTCA
GTTGACGGCCAAGGATGCC -> TTGACGGCCAAGGATGCCG
GTTGCAGTAGTTATTCCTG -> TTGCAGTAGTTATTCCTGC
GTTGCATAATGCAAATGGC -> TTGCATAATGCAAATGGCC
GTTGCTGGCTCCCGGAAGG -> TTGCTGGCTCCCGGAAGGA
GTTGGAAAGGATGCGCGTA -> TTGGAAAGGATGCGCGTAC
GTTGGACAACAGCGGTTCC -> TTGGACAACAGCGGTTCCA
GTTGGACGCACATACCGTC -> TTGGACGCACATACCGTCC
GTTGGCAATCACACTGCCA -> TTGGCAATCACACTGCCAT
GTTGGGGGTAAGACGAGGC -> TTGGGGGTAAGACGAGGCT
GTTGTCAAATGCCTAATAT -> TTGTCAAATGCCTAATATC
GTTGTCCGAATTACTGGCA -> TTGTCCGAATTACTGGCAT
GTTGTGGTTGAAATTCCAA -> TTGTGGTTGAAATTCCAAG
GTTTATCTCGCAAACGACC -> TTTATCTCGCAAACGACCT
GTTTCCACCCGAATACCTA -> TTTCCACCCGAATACCTAA
GTTTGTTGCATAATGCAAA -> TTTGTTGCATAATGCAAAT
GTTTTGAGCAAGTCCACAT -> TTTTGAGCAAGTCCACATT
TAAAACTGGTCAATCAACA -> AAAACTGGTCAATCAACAG
TAAAAGCGCGGAGGTACTG -> AAAAGCGCGGAGGTACTGC
TAAAATTAGATAGTAGGCT -> AAAATTAGATAGTAGGCTG
TAAACCAGGTCACACGGGC -> AAACCAGGTCACACGGGCA
TAAACCGGAGACGTCTTAT -> AAACCGGAGACGTCTTATT
TAAACCGTCCCTTATTGTA -> AAACCGTCCCTTATTGTAA
TAAACTTCTGGTGTAACCG -> AAACTTCTGGTGTAACCGC
TAAAGCCGTTCATACTCCT -> AAAGCCGTTCATACTCCTA
TAAAGCGGCCCTCTACTGG -> AAAGCGGCCCTCTACTGGT
TAAAGCTGCCTCTTGACTA -> AAAGCTGCCTCTTGACTAT
TAAAGGTGTATTCATATAG -> AAAGGTGTATTCATATAGG
TAAAGTACCCCCTAAGAAA -> AAAGTACCCCCTAAGAAAG
TAAATACTATAAGCTAGTC -> AAATACTATAAGCTAGTCA
TAAATGGTTAGCTGCACCG -> AAATGGTTAGCTGCACCGG
TAAATTGAGCAAGTCCACA -> AAATTGAGCAAGTCCACAT
TAACACTTCTATAGACTAT -> AACACTTCTATAGACTATA
TAACAGTAAAACTGGTCAA -> AACAGTAAAACTGGTCAAT
TAACATAGAATATGTAAAT -> AACATAGAATATGTAAATT
TAACATAGCATGTGCGTTT -> AACATAGCATGTGCGTTTT
TAACATAGGCATTTGTAGA -> AACATAGGCATTTGTAGAC
TAACATAGTTACCCCCTTA -> AACATAGTTACCCCCTTAT
TAACCCGGAGTAGCAGTAC -> AACCCGGAGTAGCAGTACC
TAACCCTATTTAGGCTGCA -> AACCCTATTTAGGCTGCAA
TAACCCTCGCAGAGAACTC -> AACCCTCGCAGAGAACTCT
TAACCGCTGGCCAAATAAC -> AACCGCTGGCCAAATAACC
TAACCTACAGTGCTGAGGC -> AACCTACAGTGCTGAGGCT
TAACCTTAAAATTAGATAG -> AACCTTAAAATTAGATAGT
TAACGGGTGTGTCCCCAAA -> AACGGGTGTGTCCCCAAAA
TAACTTATTAGCAACCACA -> AACTTATTAGCAACCACAA
TAAGAAAGCTTAACCTACA -> AAGAAAGCTTAACCTACAG
TAAGAAATTATAATTACGG -> AAGAAATTATAATTACGGA
TAAGACATCAAGGAATAAG -> AAGACATCAAGGAATAAGA
TAAGACGAGGCTCACGACA -> AAGACGAGGCTCACGACAT
TAAGATTCCTGGAATCATA -> AAGATTCCTGGAATCATAC
TAAGCCCTCAATGCATTGG -> AAGCCCTCAATGCATTGGC
TAAGCTAGTCAGACCTGTT -> AAGCTAGTCAGACCTGTTC
TAAGGTGCTATCAGAGAGC -> AAGGTGCTATCAGAGAGCA
TAAGTGATGCGGTTGGACG -> AAGTGATGCGGTTGGACGC
TAATAACCCTCGCAGAGAA -> AATAACCCTCGCAGAGAAC
TAATATCGATCCGGGAAGC -> AATATCGATCCGGGAAGCC
TAATCAAGTTCACTGACAA -> AATCAAGTTCACTGACAAA
TAATGAAGGTCATCCACTC -> AATGAAGGTCATCCACTCT
TAATGCAAATGGCCTGGAA -> AATGCAAATGGCCTGGAAG
TAATGCGAGTGTATAGTTG -> AATGCGAGTGTATAGTTGT
TAATGTACGCAGAAGACGA -> AATGTACGCAGAAGACGAC
TAATGTTGGACAACAGCGG -> AATGTTGGACAACAGCGGT
TAATTACGGATCCGCTTGT -> AATTACGGATCCGCTTGTT
TAATTCTTCTGCGCTTAGG -> AATTCTTCTGCGCTTAGGG
TAATTGGACTTTAAATACT -> AATTGGACTTTAAATACTA
TAATTTGGCATGTGTTTCC -> AATTTGGCATGTGTTTCCA
TACAGTGCTGAGGCTTGTC -> ACAGTGCTGAGGCTTGTCT
TACATAGTCCCTATAATTT -> ACATAGTCCCTATAATTTG
TACATTCGTCCAGTGCCCT -> ACATTCGTCCAGTGCCCTT
TACCAGTAGACACTTCCCG -> ACCAGTAGACACTTCCCGC
TACCCAATTGCATCGGCAG -> ACCCAATTGCATCGGCAGT
TACCCCCTAAGAAAGCTTA -> ACCCCCTAAGAAAGCTTAA
TACCCCCTTATGAGCAAGT -> ACCCCCTTATGAGCAAGTC
TACCGCTTCTCCGTAGACG -> ACCGCTTCTCCGTAGACGC
TACCGTCCAGATTTTCATG -> ACCGTCCAGATTTTCATGT
TACCTAATTCTTCTGCGCT -> ACCTAATTCTTCTGCGCTT
TACGATGGTCGGCGGCTGA -> ACGATGGTCGGCGGCTGAG
TACGCAGAAGACGACATTG -> ACGCAGAAGACGACATTGA
TACGCGATAGGTATCGGGT -> ACGCGATAGGTATCGGGTA
TACGGATCCGCTTGTTGGG -> ACGGATCCGCTTGTTGGGG
TACGGTGGTGCATATCCAA -> ACGGTGGTGCATATCCAAA
TACTAACTTATTAGCAACC -> ACTAACTTATTAGCAACCA
TACTACGATGGTCGGCGGC -> ACTACGATGGTCGGCGGCT
TACTATAAGCTAGTCAGAC -> ACTATAAGCTAGTCAGACC
TACTCCTAATTGGACTTTA -> ACTCCTAATTGGACTTTAA
TACTGCTTAAAGCCGTTCA -> ACTGCTTAAAGCCGTTCAT
TACTGGCATCAAGACGGTC -> ACTGGCATCAAGACGGTCT
TACTGGCCTGGTAGACGCT -> ACTGGCCTGGTAGACGCTT
TACTGGTAATGTACGCAGA -> ACTGGTAATGTACGCAGAA
TACTTATTCAGGCTGAGGC -> ACTTATTCAGGCTGAGGCC
TACTTGAATAGTAGACGCT -> ACTTGAATAGTAGACGCTT
TACTTGGCCGATTATGTAA -> ACTTGGCCGATTATGTAAT
TACTTGGGTGTCGAATCAA -> ACTTGGGTGTCGAATCAAG
TACTTGTAAGCCCTCAATG -> ACTTGTAAGCCCTCAATGC
TACTTTCTGGTTGTCCGAA -> ACTTTCTGGTTGTCCGAAT
TAGAATATGTAAATTGAGC -> AGAATATGTAAATTGAGCA
TAGACACTTCCCGCCGTTA -> AGACACTTCCCGCCGTTAA
TAGACGCTTTAACATAGAA -> AGACGCTTTAACATAGAAT
TAGACGCTTTAACATAGCA -> AGACGCTTTAACATAGCAT
TAGACGCTTTAACATAGGC -> AGACGCTTTAACATAGGCA
TAGACGCTTTAACATAGTT -> AGACGCTTTAACATAGTTA
TAGACTATAGTTGTGGTTG -> AGACTATAGTTGTGGTTGA
TAGAGTATCGCTGAAATAG -> AGAGTATCGCTGAAATAGT
TAGATAGTAGGCTGTTTAT -> AGATAGTAGGCTGTTTATC
TAGCAACCACAAATAAAGT -> AGCAACCACAAATAAAGTA
TAGCAGTACCAGTAGACAC -> AGCAGTACCAGTAGACACT
TAGCATGTGCGTTTTGAGC -> AGCATGTGCGTTTTGAGCA
TAGCTATCCCGTGCATGGC -> AGCTATCCCGTGCATGGCG
TAGCTGCACCGGACACGAA -> AGCTGCACCGGACACGAAG
TAGGAAGTGAGAGTCCCCC -> AGGAAGTGAGAGTCCCCCG
TAGGAATTCCTATAACGGG -> AGGAATTCCTATAACGGGT
TAGGCATTTGTAGACGCTT -> AGGCATTTGTAGACGCTTT
TAGGCGAAAACGTCCGTAC -> AGGCGAAAACGTCCGTACT
TAGGCTGCAATGGAGCTTG -> AGGCTGCAATGGAGCTTGT
TAGGCTGTTTATCTCGCAA -> AGGCTGTTTATCTCGCAAA
TAGGGTATCAACAGTACGC -> AGGGTATCAACAGTACGCG
TAGGTATCGGGTAAGAAAT -> AGGTATCGGGTAAGAAATT
TAGTACTTGTAAGCCCTCA -> AGTACTTGTAAGCCCTCAA
TAGTAGACGCTTTAACATA -> AGTAGACGCTTTAACATAG
TAGTAGGCTGTTTATCTCG -> AGTAGGCTGTTTATCTCGC
TAGTCAGACCTGTTCAGCA -> AGTCAGACCTGTTCAGCAA
TAGTCCCTATAATTTGGCA -> AGTCCCTATAATTTGGCAT
TAGTCTGCAAATATACTTT -> AGTCTGCAAATATACTTTC
TAGTGGCGTGAATGGTATG -> AGTGGCGTGAATGGTATGG
TAGTGTGGATAAACCGGAG -> AGTGTGGATAAACCGGAGA
TAGTTACCCCCTTATGAGC -> AGTTACCCCCTTATGAGCA
TAGTTAGCTATCCCGTGCA -> AGTTAGCTATCCCGTGCAT
TAGTTATTCCTGCATTGGA -> AGTTATTCCTGCATTGGAA
TAGTTGTCAAATGCCTAAT -> AGTTGTCAAATGCCTAATA
TAGTTGTGGTTGAAATTCC -> AGTTGTGGTTGAAATTCCA
TATAACGGGTGTGTCCCCA -> ATAACGGGTGTGTCCCCAA
TATAAGACATCAAGGAATA -> ATAAGACATCAAGGAATAA
TATAAGCTAGTCAGACCTG -> ATAAGCTAGTCAGACCTGT
TATAATTACGGATCCGCTT -> ATAATTACGGATCCGCTTG
TATAATTTGGCATGTGTTT -> ATAATTTGGCATGTGTTTC
TATACTTTCTGGTTGTCCG -> ATACTTTCTGGTTGTCCGA
TATAGACTATAGTTGTGGT -> ATAGACTATAGTTGTGGTT
TATAGGCGAAAACGTCCGT -> ATAGGCGAAAACGTCCGTA
TATAGTTGTCAAATGCCTA -> ATAGTTGTCAAATGCCTAA
TATAGTTGTGGTTGAAATT -> ATAGTTGTGGTTGAAATTC
TATCAACAGTACGCGATAG -> ATCAACAGTACGCGATAGG
TATCAGAGAGCATGTAAAC -> ATCAGAGAGCATGTAAACC
TATCATGGAGTAGTGGCGT -> ATCATGGAGTAGTGGCGTG
TATCCAAATAATGTTGGAC -> ATCCAAATAATGTTGGACA
TATCCCGTGCATGGCGGAT -> ATCCCGTGCATGGCGGATG
TATCCGCATCGTAATGAAG -> ATCCGCATCGTAATGAAGG
TATCGAGTTGACGGCCAAG -> ATCGAGTTGACGGCCAAGG
TATCGATCCGGGAAGCCGC -> ATCGATCCGGGAAGCCGCA
TATCGCTGAAATAGTACTT -> ATCGCTGAAATAGTACTTG
TATCGGCAGATCGTGATCG -> ATCGGCAGATCGTGATCGC
TATCGGGTAAGAAATTATA -> ATCGGGTAAGAAATTATAA
TATCTCGCAAACGACCTTT -> ATCTCGCAAACGACCTTTG
TATCTTCCTCTCGCTTAAC -> ATCTTCCTCTCGCTTAACC
TATGAGCAAGTCCACATTG -> ATGAGCAAGTCCACATTGC
TATGGAAAGGGCAGTAACA -> ATGGAAAGGGCAGTAACAG
TATGGTCTAGAGTATCGCT -> ATGGTCTAGAGTATCGCTG
TATGTAAATTGAGCAAGTC -> ATGTAAATTGAGCAAGTCC
TATGTAATCAAGTTCACTG -> ATGTAATCAAGTTCACTGA
TATTAATGCGAGTGTATAG -> ATTAATGCGAGTGTATAGT
TATTAGCAACCACAAATAA -> ATTAGCAACCACAAATAAA
TATTCAAGGATGGTTAACC -> ATTCAAGGATGGTTAACCT
TATTCAGAGACATTCTCAG -> ATTCAGAGACATTCTCAGG
TATTCAGGCTGAGGCCGTA -> ATTCAGGCTGAGGCCGTAA
TATTCATATAGGCGAAAAC -> ATTCATATAGGCGAAAACG
TATTCCGGGATGTCCTATC -> ATTCCGGGATGTCCTATCT
TATTCCTGCATTGGAATTT -> ATTCCTGCATTGGAATTTT
TATTGTAACACTTCTATAG -> ATTGTAACACTTCTATAGA
TATTTAGGCTGCAATGGAG -> ATTTAGGCTGCAATGGAGC
TCAAATCACTCCCCGTGTC -> CAAATCACTCCCCGTGTCA
TCAAATGCCTAATATCGAT -> CAAATGCCTAATATCGATC
TCAACAGGACCGGGTTCGT -> CAACAGGACCGGGTTCGTG
TCAACAGTACGCGATAGGT -> CAACAGTACGCGATAGGTA
TCAAGACGGTCTTTGGTCC -> CAAGACGGTCTTTGGTCCA
TCAAGATCTTGAAACAGAG -> CAAGATCTTGAAACAGAGG
TCAAGCAAATTAATAACCC -> CAAGCAAATTAATAACCCT
TCAAGCAAGCAGCTGGGTT -> CAAGCAAGCAGCTGGGTTA
TCAAGGAATAAGATTCCTG -> CAAGGAATAAGATTCCTGG
TCAAGGATGGTTAACCTTA -> CAAGGATGGTTAACCTTAA
TCAAGTTCACTGACAAAGT -> CAAGTTCACTGACAAAGTG
TCAATCAACAGGACCGGGT -> CAATCAACAGGACCGGGTT
TCAATGCATTGGCGGCGGA -> CAATGCATTGGCGGCGGAT
TCACACGGGCAAAGTTGGC -> CACACGGGCAAAGTTGGCA
TCACACTGCCATAAGTGAT -> CACACTGCCATAAGTGATG
TCACGACATTGGGTAAAGC -> CACGACATTGGGTAAAGCT
TCACGCGCCCATCTCTCGA -> CACGCGCCCATCTCTCGAC
TCACTACGGTGGTGCATAT -> CACTACGGTGGTGCATATC
TCACTCCCCGTGTCATGTG -> CACTCCCCGTGTCATGTGT
TCACTGACAAAGTGCGGAT -> CACTGACAAAGTGCGGATT
TCAGACCTACTTGAATAGT -> CAGACCTACTTGAATAGTA
TCAGACCTGTTCAGCAAGT -> CAGACCTGTTCAGCAAGTT
TCAGAGACATTCTCAGGCC -> CAGAGACATTCTCAGGCCA
TCAGAGAGCATGTAAACCG -> CAGAGAGCATGTAAACCGT
TCAGAGCTACCCAATTGCA -> CAGAGCTACCCAATTGCAT
TCAGCAAGTTGCTGGCTCC -> CAGCAAGTTGCTGGCTCCC
TCAGGCCAGAGCCTGGGGT -> CAGGCCAGAGCCTGGGGTC
TCAGGCTGAGGCCGTAAAG -> CAGGCTGAGGCCGTAAAGG
TCATAAACTTCTGGTGTAA -> CATAAACTTCTGGTGTAAC
TCATACTACGATGGTCGGC -> CATACTACGATGGTCGGCG
TCATACTCCTAATTGGACT -> CATACTCCTAATTGGACTT
TCATATAGGCGAAAACGTC -> CATATAGGCGAAAACGTCC
TCATATTCCGGGATGTCCT -> CATATTCCGGGATGTCCTA
TCATCCACTCTTATCGAGT -> CATCCACTCTTATCGAGTT
TCATGGAGTAGTGGCGTGA -> CATGGAGTAGTGGCGTGAA
TCATGTAAGGTGCTATCAG -> CATGTAAGGTGCTATCAGA
TCATGTGTGGTCGGCATTA -> CATGTGTGGTCGGCATTAC
TCATTCATAAACTTCTGGT -> CATTCATAAACTTCTGGTG
TCCAAATAATGTTGGACAA -> CCAAATAATGTTGGACAAC
TCCAAGAAAGGTATAAGAC -> CCAAGAAAGGTATAAGACA
TCCAAGTATTCAGAGACAT -> CCAAGTATTCAGAGACATT
TCCACATTGCCCGCTCGTG -> CCACATTGCCCGCTCGTGA
TCCACATTGCCGCAGTCGA -> CCACATTGCCGCAGTCGAA
TCCACATTGCCGTGCAGGG -> CCACATTGCCGTGCAGGGC
TCCACATTGCCTGACATTG -> CCACATTGCCTGACATTGA
TCCACCCGAATACCTAATT -> CCACCCGAATACCTAATTC
TCCACTAGTTAGCTATCCC -> CCACTAGTTAGCTATCCCG
TCCACTCTTATCGAGTTGA -> CCACTCTTATCGAGTTGAC
TCCAGAAGGGGCGCTATCG -> CCAGAAGGGGCGCTATCGG
TCCAGATTTTCATGTAAGG -> CCAGATTTTCATGTAAGGT
TCCAGCTTCAAGCAAGCAG -> CCAGCTTCAAGCAAGCAGC
TCCAGTGCCCTTCTCAGAG -> CCAGTGCCCTTCTCAGAGC
TCCCCAAAACGCTGCCGAT -> CCCCAAAACGCTGCCGATG
TCCCCCGGTACTTATTCAG -> CCCCCGGTACTTATTCAGG
TCCCCGTGTCATGTGTGGT -> CCCCGTGTCATGTGTGGTC
TCCCGCCGTTAAACCAGGT -> CCCGCCGTTAAACCAGGTC
TCCCGGAAGGATAAATGGT -> CCCGGAAGGATAAATGGTT
TCCCGTGCATGGCGGATGC -> CCCGTGCATGGCGGATGCT
TCCCTATAATTTGGCATGT -> CCCTATAATTTGGCATGTG
TCCCTTATTGTAACACTTC -> CCCTTATTGTAACACTTCT
TCCGAATTACTGGCATCAA -> CCGAATTACTGGCATCAAG
TCCGAGATCGATGCGACAG -> CCGAGATCGATGCGACAGG
TCCGCATCGTAATGAAGGT -> CCGCATCGTAATGAAGGTC
TCCGCCGTATCATGGAGTA -> CCGCCGTATCATGGAGTAG
TCCGCTTGTTGGGGGTAAG -> CCGCTTGTTGGGGGTAAGA
TCCGGGAAGCCGCACCTGA -> CCGGGAAGCCGCACCTGAG
TCCGGGATGTCCTATCTTC -> CCGGGATGTCCTATCTTCC
TCCGTACTGGCCTGGTAGA -> CCGTACTGGCCTGGTAGAC
TCCGTAGACGCTTTAACAT -> CCGTAGACGCTTTAACATA
TCCTAATTGGACTTTAAAT -> CCTAATTGGACTTTAAATA
TCCTATAACGGGTGTGTCC -> CCTATAACGGGTGTGTCCC
TCCTATCTTCCTCTCGCTT -> CCTATCTTCCTCTCGCTTA
TCCTCTCGCTTAACCCTAT -> CCTCTCGCTTAACCCTATT
TCCTGCATTGGAATTTTGA -> CCTGCATTGGAATTTTGAA
TCCTGGAATCATACCCAGC -> CCTGGAATCATACCCAGCG
TCGAAAGCAAAGGGTTAAA -> CGAAAGCAAAGGGTTAAAA
TCGAATCAAGATCTTGAAA -> CGAATCAAGATCTTGAAAC
TCGACAGCCCACTCCAGAA -> CGACAGCCCACTCCAGAAG
TCGAGTTGACGGCCAAGGA -> CGAGTTGACGGCCAAGGAT
TCGATCCGGGAAGCCGCAC -> CGATCCGGGAAGCCGCACC
TCGATGCGACAGGCGGAAC -> CGATGCGACAGGCGGAACC
TCGCAAACGACCTTTGCGT -> CGCAAACGACCTTTGCGTT
TCGCAAGGGTATGGAAAGG -> CGCAAGGGTATGGAAAGGG
TCGCAGAGAACTCTTCTTT -> CGCAGAGAACTCTTCTTTC
TCGCTGAAATAGTACTTGT -> CGCTGAAATAGTACTTGTA
TCGCTGTCTACATAGTCCC -> CGCTGTCTACATAGTCCCT
TCGCTTAACCCTATTTAGG -> CGCTTAACCCTATTTAGGC
TCGGATTCACGCGCCCATC -> CGGATTCACGCGCCCATCT
TCGGCAGATCGTGATCGCA -> CGGCAGATCGTGATCGCAA
TCGGCAGTCACTACGGTGG -> CGGCAGTCACTACGGTGGT
TCGGCATTACATTCGTCCA -> CGGCATTACATTCGTCCAG
TCGGCGGCTGAGCCGCCCA -> CGGCGGCTGAGCCGCCCAG
TCGGGTAAGAAATTATAAT -> CGGGTAAGAAATTATAATT
TCGTAATGAAGGTCATCCA -> CGTAATGAAGGTCATCCAC
TCGTCCAGTGCCCTTCTCA -> CGTCCAGTGCCCTTCTCAG
TCGTGAAAGCCCTTTCAAA -> CGTGAAAGCCCTTTCAAAT
TCGTGATCGCAAGGGTATG -> CGTGATCGCAAGGGTATGG
TCGTGGCAGTAGGAATTCC -> CGTGGCAGTAGGAATTCCT
TCTACATAGTCCCTATAAT -> CTACATAGTCCCTATAATT
TCTACTGGTAATGTACGCA -> CTACTGGTAATGTACGCAG
TCTAGAGTATCGCTGAAAT -> CTAGAGTATCGCTGAAATA
TCTAGTCTGCAAATATACT -> CTAGTCTGCAAATATACTT
TCTATAGACTATAGTTGTG -> CTATAGACTATAGTTGTGG
TCTCAGAGCTACCCAATTG -> CTCAGAGCTACCCAATTGC
TCTCAGGCCAGAGCCTGGG -> CTCAGGCCAGAGCCTGGGG
TCTCCGTAGACGCTTTAAC -> CTCCGTAGACGCTTTAACA
TCTCGACAGCCCACTCCAG -> CTCGACAGCCCACTCCAGA
TCTCGCAAACGACCTTTGC -> CTCGCAAACGACCTTTGCG
TCTCGCTTAACCCTATTTA -> CTCGCTTAACCCTATTTAG
TCTCTCGACAGCCCACTCC -> CTCTCGACAGCCCACTCCA
TCTGCAAATATACTTTCTG -> CTGCAAATATACTTTCTGG
TCTGCGCTTAGGGTATCAA -> CTGCGCTTAGGGTATCAAC
TCTGGTGTAACCGCTGGCC -> CTGGTGTAACCGCTGGCCA
TCTGGTTGTCCGAATTACT -> CTGGTTGTCCGAATTACTG
TCTTATCGAGTTGACGGCC -> CTTATCGAGTTGACGGCCA
TCTTATTAATGCGAGTGTA -> CTTATTAATGCGAGTGTAT
TCTTCCTCTCGCTTAACCC -> CTTCCTCTCGCTTAACCCT
TCTTCTGCGCTTAGGGTAT -> CTTCTGCGCTTAGGGTATC
TCTTCTTTCGGATTCACGC -> CTTCTTTCGGATTCACGCG
TCTTGAAACAGAGGGGCGT -> CTTGAAACAGAGGGGCGTG
TCTTGACTATCCGCATCGT -> CTTGACTATCCGCATCGTA
TCTTTACTTGGGTGTCGAA -> CTTTACTTGGGTGTCGAAT
TCTTTCGGATTCACGCGCC -> CTTTCGGATTCACGCGCCC
TCTTTGGTCCACTAGTTAG -> CTTTGGTCCACTAGTTAGC
TGAAACAGAGGGGCGTGCC -> GAAACAGAGGGGCGTGCCC
TGAAAGCCCTTTCAAATCA -> GAAAGCCCTTTCAAATCAC
TGAAATAGTACTTGTAAGC -> GAAATAGTACTTGTAAGCC
TGAAATTCCAAGTATTCAG -> GAAATTCCAAGTATTCAGA
TGAACACCGGTTCATTCAT -> GAACACCGGTTCATTCATA
TGAAGGTCATCCACTCTTA -> GAAGGTCATCCACTCTTAT
TGAATACCGCTTCTCCGTA -> GAATACCGCTTCTCCGTAG
TGAATAGTAGACGCTTTAA -> GAATAGTAGACGCTTTAAC
TGAATGGTATGGTCTAGAG -> GAATGGTATGGTCTAGAGT
TGAATTCGCTGTCTACATA -> GAATTCGCTGTCTACATAG
TGACAAAGTGCGGATTGTC -> GACAAAGTGCGGATTGTCT
TGACATTGAGCAAGTCCAC -> GACATTGAGCAAGTCCACA
TGACGGCCAAGGATGCCGG -> GACGGCCAAGGATGCCGGC
TGACTATCCGCATCGTAAT -> GACTATCCGCATCGTAATG
TGAGAAAGTTGCAGTAGTT -> GAGAAAGTTGCAGTAGTTA
TGAGAGTCCCCCGGTACTT -> GAGAGTCCCCCGGTACTTA
TGAGCAAGTCCACATTGCC -> GAGCAAGTCCACATTGCCC,GAGCAAGTCCACATTGCCG,GAGCAAGTCCACATTGCCG,GAGCAAGTCCACATTGCCT
TGAGCCGCCCAGCTAAAGC -> GAGCCGCCCAGCTAAAGCG
TGAGGCCGTAAAGGTGTAT -> GAGGCCGTAAAGGTGTATT
TGAGGCTTGTCTAGTCTGC -> GAGGCTTGTCTAGTCTGCA
TGATCGCAAGGGTATGGAA -> GATCGCAAGGGTATGGAAA
TGATGCGGTTGGACGCACA -> GATGCGGTTGGACGCACAT
TGCAAATATACTTTCTGGT -> GCAAATATACTTTCTGGTT
TGCAAATGGCCTGGAAGTC -> GCAAATGGCCTGGAAGTCC
TGCAATGGAGCTTGTTGGA -> GCAATGGAGCTTGTTGGAA
TGCACCGGACACGAAGACA -> GCACCGGACACGAAGACAA
TGCAGATCATATTCCGGGA -> GCAGATCATATTCCGGGAT
TGCAGGGCAGTTACTAACT -> GCAGGGCAGTTACTAACTT
TGCAGTAGTTATTCCTGCA -> GCAGTAGTTATTCCTGCAT
TGCATAATGCAAATGGCCT -> GCATAATGCAAATGGCCTG
TGCATATCCAAATAATGTT -> GCATATCCAAATAATGTTG
TGCATCGGCAGTCACTACG -> GCATCGGCAGTCACTACGG
TGCATGGCGGATGCTCCGA -> GCATGGCGGATGCTCCGAG
TGCATTGGAATTTTGAATT -> GCATTGGAATTTTGAATTC
TGCATTGGCGGCGGATTAG -> GCATTGGCGGCGGATTAGG
TGCCATAAGTGATGCGGTT -> GCCATAAGTGATGCGGTTG
TGCCCGAGGCGTGGCATGA -> GCCCGAGGCGTGGCATGAA
TGCCCGCTCGTGAAAGCCC -> GCCCGCTCGTGAAAGCCCT
TGCCCTTCTCAGAGCTACC -> GCCCTTCTCAGAGCTACCC
TGCCGATGCAGATCATATT -> GCCGATGCAGATCATATTC
TGCCGCAGTCGAAAGCAAA -> GCCGCAGTCGAAAGCAAAG
TGCCGGCGGTCAGACCTAC -> GCCGGCGGTCAGACCTACT
TGCCGTGCAGGGCAGTTAC -> GCCGTGCAGGGCAGTTACT
TGCCTAATATCGATCCGGG -> GCCTAATATCGATCCGGGA
TGCCTCTTGACTATCCGCA -> GCCTCTTGACTATCCGCAT
TGCCTGACATTGAGCAAGT -> GCCTGACATTGAGCAAGTC
TGCGACAGGCGGAACCCGA -> GCGACAGGCGGAACCCGAG
TGCGAGTGTATAGTTGTCA -> GCGAGTGTATAGTTGTCAA
TGCGCGTACTTGGCCGATT -> GCGCGTACTTGGCCGATTA
TGCGCTTAGGGTATCAACA -> GCGCTTAGGGTATCAACAG
TGCGGATTGTCTTTACTTG -> GCGGATTGTCTTTACTTGG
TGCGGTTGGACGCACATAC -> GCGGTTGGACGCACATACC
TGCGTTTGTTGCATAATGC -> GCGTTTGTTGCATAATGCA
TGCGTTTTGAGCAAGTCCA -> GCGTTTTGAGCAAGTCCAC
TGCTATCAGAGAGCATGTA -> GCTATCAGAGAGCATGTAA
TGCTCCGAGATCGATGCGA -> GCTCCGAGATCGATGCGAC
TGCTGAGGCTTGTCTAGTC -> GCTGAGGCTTGTCTAGTCT
TGCTGGCTCCCGGAAGGAT -> GCTGGCTCCCGGAAGGATA
TGCTTAAAGCCGTTCATAC -> GCTTAAAGCCGTTCATACT
TGGAAAGGATGCGCGTACT -> GGAAAGGATGCGCGTACTT
TGGAAAGGGCAGTAACAGT -> GGAAAGGGCAGTAACAGTA
TGGAAGTCCAGCTTCAAGC -> GGAAGTCCAGCTTCAAGCA
TGGAATCATACCCAGCGCT -> GGAATCATACCCAGCGCTT
TGGAATTTTGAATTCGCTG -> GGAATTTTGAATTCGCTGT
TGGACAACAGCGGTTCCAA -> GGACAACAGCGGTTCCAAG
TGGACGCACATACCGTCCA -> GGACGCACATACCGTCCAG
TGGACTTTAAATACTATAA -> GGACTTTAAATACTATAAG
TGGAGCTTGTTGGAAAGGA -> GGAGCTTGTTGGAAAGGAT
TGGAGTAGTGGCGTGAATG -> GGAGTAGTGGCGTGAATGG
TGGATAAACCGGAGACGTC -> GGATAAACCGGAGACGTCT
TGGCAATCACACTGCCATA -> GGCAATCACACTGCCATAA
TGGCAGTAGGAATTCCTAT -> GGCAGTAGGAATTCCTATA
TGGCATCAAGACGGTCTTT -> GGCATCAAGACGGTCTTTG
TGGCATGAACACCGGTTCA -> GGCATGAACACCGGTTCAT
TGGCATGTGTTTCCACCCG -> GGCATGTGTTTCCACCCGA
TGGCCAAATAACCCGGAGT -> GGCCAAATAACCCGGAGTA
TGGCCGATTATGTAATCAA -> GGCCGATTATGTAATCAAG
TGGCCTGGAAGTCCAGCTT -> GGCCTGGAAGTCCAGCTTC
TGGCCTGGTAGACGCTTTA -> GGCCTGGTAGACGCTTTAA
TGGCGGATGCTCCGAGATC -> GGCGGATGCTCCGAGATCG
TGGCGGCGGATTAGGAAGT -> GGCGGCGGATTAGGAAGTG
TGGCGTGAATGGTATGGTC -> GGCGTGAATGGTATGGTCT
TGGCTCCCGGAAGGATAAA -> GGCTCCCGGAAGGATAAAT
TGGGGGTAAGACGAGGCTC -> GGGGGTAAGACGAGGCTCA
TGGGGTCCGCCGTATCATG -> GGGGTCCGCCGTATCATGG
TGGGTAAAGCTGCCTCTTG -> GGGTAAAGCTGCCTCTTGA
TGGGTGTCGAATCAAGATC -> GGGTGTCGAATCAAGATCT
TGGGTTAGTGTGGATAAAC -> GGGTTAGTGTGGATAAACC
TGGTAATGTACGCAGAAGA -> GGTAATGTACGCAGAAGAC
TGGTAGACGCTTTAACATA -> GGTAGACGCTTTAACATAG
TGGTATGGTCTAGAGTATC -> GGTATGGTCTAGAGTATCG
TGGTCAATCAACAGGACCG -> GGTCAATCAACAGGACCGG
TGGTCCACTAGTTAGCTAT -> GGTCCACTAGTTAGCTATC
TGGTCGGCATTACATTCGT -> GGTCGGCATTACATTCGTC
TGGTCGGCGGCTGAGCCGC -> GGTCGGCGGCTGAGCCGCC
TGGTCTAGAGTATCGCTGA -> GGTCTAGAGTATCGCTGAA
TGGTGCATATCCAAATAAT -> GGTGCATATCCAAATAATG
TGGTGTAACCGCTGGCCAA -> GGTGTAACCGCTGGCCAAA
TGGTTAACCTTAAAATTAG -> GGTTAACCTTAAAATTAGA
TGGTTAGCTGCACCGGACA -> GGTTAGCTGCACCGGACAC
TGGTTGAAATTCCAAGTAT -> GGTTGAAATTCCAAGTATT
TGGTTGTCCGAATTACTGG -> GGTTGTCCGAATTACTGGC
TGTAAACCGTCCCTTATTG -> GTAAACCGTCCCTTATTGT
TGTAAATTGAGCAAGTCCA -> GTAAATTGAGCAAGTCCAC
TGTAACACTTCTATAGACT -> GTAACACTTCTATAGACTA
TGTAACCGCTGGCCAAATA -> GTAACCGCTGGCCAAATAA
TGTAAGCCCTCAATGCATT -> GTAAGCCCTCAATGCATTG
TGTAAGGTGCTATCAGAGA -> GTAAGGTGCTATCAGAGAG
TGTAATCAAGTTCACTGAC -> GTAATCAAGTTCACTGACA
TGTACGCAGAAGACGACAT -> GTACGCAGAAGACGACATT
TGTAGACGCTTTAACATAG -> GTAGACGCTTTAACATAGT
TGTATAGTTGTCAAATGCC -> GTATAGTTGTCAAATGCCT
TGTATTCATATAGGCGAAA -> GTATTCATATAGGCGAAAA
TGTCAAATGCCTAATATCG -> GTCAAATGCCTAATATCGA
TGTCATGTGTGGTCGGCAT -> GTCATGTGTGGTCGGCATT
TGTCCCCAAAACGCTGCCG -> GTCCCCAAAACGCTGCCGA
TGTCCGAATTACTGGCATC -> GTCCGAATTACTGGCATCA
TGTCCTATCTTCCTCTCGC -> GTCCTATCTTCCTCTCGCT
TGTCGAATCAAGATCTTGA -> GTCGAATCAAGATCTTGAA
TGTCTACATAGTCCCTATA -> GTCTACATAGTCCCTATAA
TGTCTAGTCTGCAAATATA -> GTCTAGTCTGCAAATATAC
TGTCTTTACTTGGGTGTCG -> GTCTTTACTTGGGTGTCGA
TGTGCGTTTTGAGCAAGTC -> GTGCGTTTTGAGCAAGTCC
TGTGGATAAACCGGAGACG -> GTGGATAAACCGGAGACGT
TGTGGTCGGCATTACATTC -> GTGGTCGGCATTACATTCG
TGTGGTTGAAATTCCAAGT -> GTGGTTGAAATTCCAAGTA
TGTGTCCCCAAAACGCTGC -> GTGTCCCCAAAACGCTGCC
TGTGTGGTCGGCATTACAT -> GTGTGGTCGGCATTACATT
TGTGTTTCCACCCGAATAC -> GTGTTTCCACCCGAATACC
TGTTCAGCAAGTTGCTGGC -> GTTCAGCAAGTTGCTGGCT
TGTTGCATAATGCAAATGG -> GTTGCATAATGCAAATGGC
TGTTGGAAAGGATGCGCGT -> GTTGGAAAGGATGCGCGTA
TGTTGGACAACAGCGGTTC -> GTTGGACAACAGCGGTTCC
TGTTGGGGGTAAGACGAGG -> GTTGGGGGTAAGACGAGGC
TGTTTATCTCGCAAACGAC -> GTTTATCTCGCAAACGACC
TGTTTCCACCCGAATACCT -> GTTTCCACCCGAATACCTA
TTAAAAGCGCGGAGGTACT -> TAAAAGCGCGGAGGTACTG
TTAAAATTAGATAGTAGGC -> TAAAATTAGATAGTAGGCT
TTAAACCAGGTCACACGGG -> TAAACCAGGTCACACGGGC
TTAAAGCCGTTCATACTCC -> TAAAGCCGTTCATACTCCT
TTAAATACTATAAGCTAGT -> TAAATACTATAAGCTAGTC
TTAACATAGAATATGTAAA -> TAACATAGAATATGTAAAT
TTAACATAGCATGTGCGTT -> TAACATAGCATGTGCGTTT
TTAACATAGGCATTTGTAG -> TAACATAGGCATTTGTAGA
TTAACATAGTTACCCCCTT -> TAACATAGTTACCCCCTTA
TTAACCCTATTTAGGCTGC -> TAACCCTATTTAGGCTGCA
TTAACCTACAGTGCTGAGG -> TAACCTACAGTGCTGAGGC
TTAACCTTAAAATTAGATA -> TAACCTTAAAATTAGATAG
TTAATAACCCTCGCAGAGA -> TAATAACCCTCGCAGAGAA
TTAATGCGAGTGTATAGTT -> TAATGCGAGTGTATAGTTG
TTACATTCGTCCAGTGCCC -> TACATTCGTCCAGTGCCCT
TTACCCCCTTATGAGCAAG -> TACCCCCTTATGAGCAAGT
TTACGGATCCGCTTGTTGG -> TACGGATCCGCTTGTTGGG
TTACTAACTTATTAGCAAC -> TACTAACTTATTAGCAACC
TTACTGGCATCAAGACGGT -> TACTGGCATCAAGACGGTC
TTACTTGGGTGTCGAATCA -> TACTTGGGTGTCGAATCAA
TTAGATAGTAGGCTGTTTA -> TAGATAGTAGGCTGTTTAT
TTAGCAACCACAAATAAAG -> TAGCAACCACAAATAAAGT
TTAGCTATCCCGTGCATGG -> TAGCTATCCCGTGCATGGC
TTAGCTGCACCGGACACGA -> TAGCTGCACCGGACACGAA
TTAGGAAGTGAGAGTCCCC -> TAGGAAGTGAGAGTCCCCC
TTAGGCTGCAATGGAGCTT -> TAGGCTGCAATGGAGCTTG
TTAGGGTATCAACAGTACG -> TAGGGTATCAACAGTACGC
TTAGTGTGGATAAACCGGA -> TAGTGTGGATAAACCGGAG
TTATAATTACGGATCCGCT -> TATAATTACGGATCCGCTT
TTATCGAGTTGACGGCCAA -> TATCGAGTTGACGGCCAAG
TTATCTCGCAAACGACCTT -> TATCTCGCAAACGACCTTT
TTATGAGCAAGTCCACATT -> TATGAGCAAGTCCACATTG
TTATGTAATCAAGTTCACT -> TATGTAATCAAGTTCACTG
TTATTAATGCGAGTGTATA -> TATTAATGCGAGTGTATAG
TTATTAGCAACCACAAATA -> TATTAGCAACCACAAATAA
TTATTCAGGCTGAGGCCGT -> TATTCAGGCTGAGGCCGTA
TTATTCCTGCATTGGAATT -> TATTCCTGCATTGGAATTT
TTATTGTAACACTTCTATA -> TATTGTAACACTTCTATAG
TTCAAATCACTCCCCGTGT -> TCAAATCACTCCCCGTGTC
TTCAAGCAAGCAGCTGGGT -> TCAAGCAAGCAGCTGGGTT
TTCAAGGATGGTTAACCTT -> TCAAGGATGGTTAACCTTA
TTCACGCGCCCATCTCTCG -> TCACGCGCCCATCTCTCGA
TTCACTGACAAAGTGCGGA -> TCACTGACAAAGTGCGGAT
TTCAGAGACATTCTCAGGC -> TCAGAGACATTCTCAGGCC
TTCAGCAAGTTGCTGGCTC -> TCAGCAAGTTGCTGGCTCC
TTCAGGCTGAGGCCGTAAA -> TCAGGCTGAGGCCGTAAAG
TTCATAAACTTCTGGTGTA -> TCATAAACTTCTGGTGTAA
TTCATACTCCTAATTGGAC -> TCATACTCCTAATTGGACT
TTCATATAGGCGAAAACGT -> TCATATAGGCGAAAACGTC
TTCATGTAAGGTGCTATCA -> TCATGTAAGGTGCTATCAG
TTCATTCATAAACTTCTGG -> TCATTCATAAACTTCTGGT
TTCCAAGAAAGGTATAAGA -> TCCAAGAAAGGTATAAGAC
TTCCAAGTATTCAGAGACA -> TCCAAGTATTCAGAGACAT
TTCCACCCGAATACCTAAT -> TCCACCCGAATACCTAATT
TTCCCGCCGTTAAACCAGG -> TCCCGCCGTTAAACCAGGT
TTCCGGGATGTCCTATCTT -> TCCGGGATGTCCTATCTTC
TTCCTATAACGGGTGTGTC -> TCCTATAACGGGTGTGTCC
TTCCTCTCGCTTAACCCTA -> TCCTCTCGCTTAACCCTAT
TTCCTGCATTGGAATTTTG -> TCCTGCATTGGAATTTTGA
TTCCTGGAATCATACCCAG -> TCCTGGAATCATACCCAGC
TTCGCTGTCTACATAGTCC -> TCGCTGTCTACATAGTCCC
TTCGGATTCACGCGCCCAT -> TCGGATTCACGCGCCCATC
TTCGTCCAGTGCCCTTCTC -> TCGTCCAGTGCCCTTCTCA
TTCGTGGCAGTAGGAATTC -> TCGTGGCAGTAGGAATTCC
TTCTATAGACTATAGTTGT -> TCTATAGACTATAGTTGTG
TTCTCAGAGCTACCCAATT -> TCTCAGAGCTACCCAATTG
TTCTCAGGCCAGAGCCTGG -> TCTCAGGCCAGAGCCTGGG
TTCTCCGTAGACGCTTTAA -> TCTCCGTAGACGCTTTAAC
TTCTGCGCTTAGGGTATCA -> TCTGCGCTTAGGGTATCAA
TTCTGGTGTAACCGCTGGC -> TCTGGTGTAACCGCTGGCC
TTCTGGTTGTCCGAATTAC -> TCTGGTTGTCCGAATTACT
TTCTTCTGCGCTTAGGGTA -> TCTTCTGCGCTTAGGGTAT
TTCTTTCGGATTCACGCGC -> TCTTTCGGATTCACGCGCC
TTGAAACAGAGGGGCGTGC -> TGAAACAGAGGGGCGTGCC
TTGAAATTCCAAGTATTCA -> TGAAATTCCAAGTATTCAG
TTGAATACCGCTTCTCCGT -> TGAATACCGCTTCTCCGTA
TTGAATAGTAGACGCTTTA -> TGAATAGTAGACGCTTTAA
TTGAATTCGCTGTCTACAT -> TGAATTCGCTGTCTACATA
TTGACGGCCAAGGATGCCG -> TGACGGCCAAGGATGCCGG
TTGACTATCCGCATCGTAA -> TGACTATCCGCATCGTAAT
TTGAGCAAGTCCACATTGC -> TGAGCAAGTCCACATTGCC,TGAGCAAGTCCACATTGCC,TGAGCAAGTCCACATTGCC
TTGCAGTAGTTATTCCTGC -> TGCAGTAGTTATTCCTGCA
TTGCATAATGCAAATGGCC -> TGCATAATGCAAATGGCCT
TTGCATCGGCAGTCACTAC -> TGCATCGGCAGTCACTACG
TTGCCCGCTCGTGAAAGCC -> TGCCCGCTCGTGAAAGCCC
TTGCCGCAGTCGAAAGCAA -> TGCCGCAGTCGAAAGCAAA
TTGCCGTGCAGGGCAGTTA -> TGCCGTGCAGGGCAGTTAC
TTGCCTGACATTGAGCAAG -> TGCCTGACATTGAGCAAGT
TTGCGTTTGTTGCATAATG -> TGCGTTTGTTGCATAATGC
TTGCTGGCTCCCGGAAGGA -> TGCTGGCTCCCGGAAGGAT
TTGGAAAGGATGCGCGTAC -> TGGAAAGGATGCGCGTACT
TTGGAATTTTGAATTCGCT -> TGGAATTTTGAATTCGCTG
TTGGACAACAGCGGTTCCA -> TGGACAACAGCGGTTCCAA
TTGGACGCACATACCGTCC -> TGGACGCACATACCGTCCA
TTGGACTTTAAATACTATA -> TGGACTTTAAATACTATAA
TTGGCAATCACACTGCCAT -> TGGCAATCACACTGCCATA
TTGGCATGTGTTTCCACCC -> TGGCATGTGTTTCCACCCG
TTGGCCGATTATGTAATCA -> TGGCCGATTATGTAATCAA
TTGGCGGCGGATTAGGAAG -> TGGCGGCGGATTAGGAAGT
TTGGGGGTAAGACGAGGCT -> TGGGGGTAAGACGAGGCTC
TTGGGTAAAGCTGCCTCTT -> TGGGTAAAGCTGCCTCTTG
TTGGGTGTCGAATCAAGAT -> TGGGTGTCGAATCAAGATC
TTGGTCCACTAGTTAGCTA -> TGGTCCACTAGTTAGCTAT
TTGTAACACTTCTATAGAC -> TGTAACACTTCTATAGACT
TTGTAAGCCCTCAATGCAT -> TGTAAGCCCTCAATGCATT
TTGTAGACGCTTTAACATA -> TGTAGACGCTTTAACATAG
TTGTCAAATGCCTAATATC -> TGTCAAATGCCTAATATCG
TTGTCCGAATTACTGGCAT -> TGTCCGAATTACTGGCATC
TTGTCTAGTCTGCAAATAT -> TGTCTAGTCTGCAAATATA
TTGTCTTTACTTGGGTGTC -> TGTCTTTACTTGGGTGTCG
TTGTGGTTGAAATTCCAAG -> TGTGGTTGAAATTCCAAGT
TTGTTGCATAATGCAAATG -> TGTTGCATAATGCAAATGG
TTGTTGGAAAGGATGCGCG -> TGTTGGAAAGGATGCGCGT
TTGTTGGGGGTAAGACGAG -> TGTTGGGGGTAAGACGAGG
TTTAAATACTATAAGCTAG -> TTAAATACTATAAGCTAGT
TTTAACATAGAATATGTAA -> TTAACATAGAATATGTAAA
TTTAACATAGCATGTGCGT -> TTAACATAGCATGTGCGTT
TTTAACATAGGCATTTGTA -> TTAACATAGGCATTTGTAG
TTTAACATAGTTACCCCCT -> TTAACATAGTTACCCCCTT
TTTACTTGGGTGTCGAATC -> TTACTTGGGTGTCGAATCA
TTTAGGCTGCAATGGAGCT -> TTAGGCTGCAATGGAGCTT
TTTATCTCGCAAACGACCT -> TTATCTCGCAAACGACCTT
TTTCAAATCACTCCCCGTG -> TTCAAATCACTCCCCGTGT
TTTCATGTAAGGTGCTATC -> TTCATGTAAGGTGCTATCA
TTTCCACCCGAATACCTAA -> TTCCACCCGAATACCTAAT
TTTCGGATTCACGCGCCCA -> TTCGGATTCACGCGCCCAT
TTTCTGGTTGTCCGAATTA -> TTCTGGTTGTCCGAATTAC
TTTGAATTCGCTGTCTACA -> TTGAATTCGCTGTCTACAT
TTTGAGCAAGTCCACATTG -> TTGAGCAAGTCCACATTGC
TTTGCGTTTGTTGCATAAT -> TTGCGTTTGTTGCATAATG
TTTGGCATGTGTTTCCACC -> TTGGCATGTGTTTCCACCC
TTTGGTCCACTAGTTAGCT -> TTGGTCCACTAGTTAGCTA
TTTGTAGACGCTTTAACAT -> TTGTAGACGCTTTAACATA
TTTGTTGCATAATGCAAAT -> TTGTTGCATAATGCAAATG
TTTTCATGTAAGGTGCTAT -> TTTCATGTAAGGTGCTATC
TTTTGAATTCGCTGTCTAC -> TTTGAATTCGCTGTCTACA
TTTTGAGCAAGTCCACATT -> TTTGAGCAAGTCCACATTG